"filename", "language", "Java", "comment", "blank", "total"
"c:\Users\zipasink\OneDrive\PhD\research\research-workspace\interactive-auto-mapping-tool\test-systems\teammates\src\main\java\teammates\common\datatransfer\CourseDetailsBundle.java", "Java", 58, 19, 12, 89
"c:\Users\zipasink\OneDrive\PhD\research\research-workspace\interactive-auto-mapping-tool\test-systems\teammates\src\main\java\teammates\common\datatransfer\CourseEnrollmentResult.java", "Java", 12, 3, 7, 22
"c:\Users\zipasink\OneDrive\PhD\research\research-workspace\interactive-auto-mapping-tool\test-systems\teammates\src\main\java\teammates\common\datatransfer\CourseRoster.java", "Java", 59, 10, 21, 90
"c:\Users\zipasink\OneDrive\PhD\research\research-workspace\interactive-auto-mapping-tool\test-systems\teammates\src\main\java\teammates\common\datatransfer\CourseStats.java", "Java", 19, 7, 6, 32
"c:\Users\zipasink\OneDrive\PhD\research\research-workspace\interactive-auto-mapping-tool\test-systems\teammates\src\main\java\teammates\common\datatransfer\CourseSummaryBundle.java", "Java", 51, 11, 12, 74
"c:\Users\zipasink\OneDrive\PhD\research\research-workspace\interactive-auto-mapping-tool\test-systems\teammates\src\main\java\teammates\common\datatransfer\DataBundle.java", "Java", 44, 10, 6, 60
"c:\Users\zipasink\OneDrive\PhD\research\research-workspace\interactive-auto-mapping-tool\test-systems\teammates\src\main\java\teammates\common\datatransfer\FeedbackParticipantType.java", "Java", 106, 36, 21, 163
"c:\Users\zipasink\OneDrive\PhD\research\research-workspace\interactive-auto-mapping-tool\test-systems\teammates\src\main\java\teammates\common\datatransfer\FeedbackResponseCommentSearchResultBundle.java", "Java", 21, 3, 6, 30
"c:\Users\zipasink\OneDrive\PhD\research\research-workspace\interactive-auto-mapping-tool\test-systems\teammates\src\main\java\teammates\common\datatransfer\FeedbackSessionDetailsBundle.java", "Java", 48, 12, 8, 68
"c:\Users\zipasink\OneDrive\PhD\research\research-workspace\interactive-auto-mapping-tool\test-systems\teammates\src\main\java\teammates\common\datatransfer\FeedbackSessionQuestionsBundle.java", "Java", 88, 24, 29, 141
"c:\Users\zipasink\OneDrive\PhD\research\research-workspace\interactive-auto-mapping-tool\test-systems\teammates\src\main\java\teammates\common\datatransfer\FeedbackSessionResponseStatus.java", "Java", 76, 27, 20, 123
"c:\Users\zipasink\OneDrive\PhD\research\research-workspace\interactive-auto-mapping-tool\test-systems\teammates\src\main\java\teammates\common\datatransfer\FeedbackSessionResultsBundle.java", "Java", 1654, 308, 300, 2262
"c:\Users\zipasink\OneDrive\PhD\research\research-workspace\interactive-auto-mapping-tool\test-systems\teammates\src\main\java\teammates\common\datatransfer\FeedbackSessionStats.java", "Java", 6, 6, 3, 15
"c:\Users\zipasink\OneDrive\PhD\research\research-workspace\interactive-auto-mapping-tool\test-systems\teammates\src\main\java\teammates\common\datatransfer\FeedbackSessionType.java", "Java", 4, 3, 2, 9
"c:\Users\zipasink\OneDrive\PhD\research\research-workspace\interactive-auto-mapping-tool\test-systems\teammates\src\main\java\teammates\common\datatransfer\InstructorPrivileges.java", "Java", 407, 45, 89, 541
"c:\Users\zipasink\OneDrive\PhD\research\research-workspace\interactive-auto-mapping-tool\test-systems\teammates\src\main\java\teammates\common\datatransfer\InstructorSearchResultBundle.java", "Java", 7, 3, 6, 16
"c:\Users\zipasink\OneDrive\PhD\research\research-workspace\interactive-auto-mapping-tool\test-systems\teammates\src\main\java\teammates\common\datatransfer\SearchResultBundle.java", "Java", 6, 4, 5, 15
"c:\Users\zipasink\OneDrive\PhD\research\research-workspace\interactive-auto-mapping-tool\test-systems\teammates\src\main\java\teammates\common\datatransfer\SectionDetailsBundle.java", "Java", 7, 6, 5, 18
"c:\Users\zipasink\OneDrive\PhD\research\research-workspace\interactive-auto-mapping-tool\test-systems\teammates\src\main\java\teammates\common\datatransfer\StudentAttributesFactory.java", "Java", 126, 16, 30, 172
"c:\Users\zipasink\OneDrive\PhD\research\research-workspace\interactive-auto-mapping-tool\test-systems\teammates\src\main\java\teammates\common\datatransfer\StudentEnrollDetails.java", "Java", 29, 0, 4, 33
"c:\Users\zipasink\OneDrive\PhD\research\research-workspace\interactive-auto-mapping-tool\test-systems\teammates\src\main\java\teammates\common\datatransfer\StudentResultSummary.java", "Java", 6, 6, 6, 18
"c:\Users\zipasink\OneDrive\PhD\research\research-workspace\interactive-auto-mapping-tool\test-systems\teammates\src\main\java\teammates\common\datatransfer\StudentSearchResultBundle.java", "Java", 11, 3, 6, 20
"c:\Users\zipasink\OneDrive\PhD\research\research-workspace\interactive-auto-mapping-tool\test-systems\teammates\src\main\java\teammates\common\datatransfer\StudentUpdateStatus.java", "Java", 30, 3, 8, 41
"c:\Users\zipasink\OneDrive\PhD\research\research-workspace\interactive-auto-mapping-tool\test-systems\teammates\src\main\java\teammates\common\datatransfer\TeamDetailsBundle.java", "Java", 8, 6, 6, 20
"c:\Users\zipasink\OneDrive\PhD\research\research-workspace\interactive-auto-mapping-tool\test-systems\teammates\src\main\java\teammates\common\datatransfer\TeamEvalResult.java", "Java", 346, 31, 75, 452
"c:\Users\zipasink\OneDrive\PhD\research\research-workspace\interactive-auto-mapping-tool\test-systems\teammates\src\main\java\teammates\common\datatransfer\UserRole.java", "Java", 4, 4, 2, 10
"c:\Users\zipasink\OneDrive\PhD\research\research-workspace\interactive-auto-mapping-tool\test-systems\teammates\src\main\java\teammates\common\datatransfer\UserType.java", "Java", 14, 6, 7, 27
"c:\Users\zipasink\OneDrive\PhD\research\research-workspace\interactive-auto-mapping-tool\test-systems\teammates\src\main\java\teammates\common\datatransfer\attributes\AccountAttributes.java", "Java", 127, 10, 34, 171
"c:\Users\zipasink\OneDrive\PhD\research\research-workspace\interactive-auto-mapping-tool\test-systems\teammates\src\main\java\teammates\common\datatransfer\attributes\AdminEmailAttributes.java", "Java", 121, 0, 34, 155
"c:\Users\zipasink\OneDrive\PhD\research\research-workspace\interactive-auto-mapping-tool\test-systems\teammates\src\main\java\teammates\common\datatransfer\attributes\CourseAttributes.java", "Java", 106, 7, 31, 144
"c:\Users\zipasink\OneDrive\PhD\research\research-workspace\interactive-auto-mapping-tool\test-systems\teammates\src\main\java\teammates\common\datatransfer\attributes\EntityAttributes.java", "Java", 21, 42, 14, 77
"c:\Users\zipasink\OneDrive\PhD\research\research-workspace\interactive-auto-mapping-tool\test-systems\teammates\src\main\java\teammates\common\datatransfer\attributes\FeedbackQuestionAttributes.java", "Java", 473, 42, 125, 640
"c:\Users\zipasink\OneDrive\PhD\research\research-workspace\interactive-auto-mapping-tool\test-systems\teammates\src\main\java\teammates\common\datatransfer\attributes\FeedbackResponseAttributes.java", "Java", 163, 37, 36, 236
"c:\Users\zipasink\OneDrive\PhD\research\research-workspace\interactive-auto-mapping-tool\test-systems\teammates\src\main\java\teammates\common\datatransfer\attributes\FeedbackResponseCommentAttributes.java", "Java", 169, 10, 30, 209
"c:\Users\zipasink\OneDrive\PhD\research\research-workspace\interactive-auto-mapping-tool\test-systems\teammates\src\main\java\teammates\common\datatransfer\attributes\FeedbackSessionAttributes.java", "Java", 520, 52, 129, 701
"c:\Users\zipasink\OneDrive\PhD\research\research-workspace\interactive-auto-mapping-tool\test-systems\teammates\src\main\java\teammates\common\datatransfer\attributes\InstructorAttributes.java", "Java", 237, 37, 65, 339
"c:\Users\zipasink\OneDrive\PhD\research\research-workspace\interactive-auto-mapping-tool\test-systems\teammates\src\main\java\teammates\common\datatransfer\attributes\SessionAttributes.java", "Java", 73, 20, 17, 110
"c:\Users\zipasink\OneDrive\PhD\research\research-workspace\interactive-auto-mapping-tool\test-systems\teammates\src\main\java\teammates\common\datatransfer\attributes\StudentAttributes.java", "Java", 259, 21, 70, 350
"c:\Users\zipasink\OneDrive\PhD\research\research-workspace\interactive-auto-mapping-tool\test-systems\teammates\src\main\java\teammates\common\datatransfer\attributes\StudentProfileAttributes.java", "Java", 193, 15, 42, 250
"c:\Users\zipasink\OneDrive\PhD\research\research-workspace\interactive-auto-mapping-tool\test-systems\teammates\src\main\java\teammates\common\datatransfer\attributes\package-info.java", "Java", 1, 3, 1, 5
"c:\Users\zipasink\OneDrive\PhD\research\research-workspace\interactive-auto-mapping-tool\test-systems\teammates\src\main\java\teammates\common\datatransfer\package-info.java", "Java", 1, 4, 1, 6
"c:\Users\zipasink\OneDrive\PhD\research\research-workspace\interactive-auto-mapping-tool\test-systems\teammates\src\main\java\teammates\common\datatransfer\questions\FeedbackConstantSumQuestionDetails.java", "Java", 639, 32, 111, 782
"c:\Users\zipasink\OneDrive\PhD\research\research-workspace\interactive-auto-mapping-tool\test-systems\teammates\src\main\java\teammates\common\datatransfer\questions\FeedbackConstantSumResponseDetails.java", "Java", 74, 3, 15, 92
"c:\Users\zipasink\OneDrive\PhD\research\research-workspace\interactive-auto-mapping-tool\test-systems\teammates\src\main\java\teammates\common\datatransfer\questions\FeedbackContributionQuestionDetails.java", "Java", 734, 86, 136, 956
"c:\Users\zipasink\OneDrive\PhD\research\research-workspace\interactive-auto-mapping-tool\test-systems\teammates\src\main\java\teammates\common\datatransfer\questions\FeedbackContributionResponseDetails.java", "Java", 173, 14, 36, 223
"c:\Users\zipasink\OneDrive\PhD\research\research-workspace\interactive-auto-mapping-tool\test-systems\teammates\src\main\java\teammates\common\datatransfer\questions\FeedbackMcqQuestionDetails.java", "Java", 441, 2, 81, 524
"c:\Users\zipasink\OneDrive\PhD\research\research-workspace\interactive-auto-mapping-tool\test-systems\teammates\src\main\java\teammates\common\datatransfer\questions\FeedbackMcqResponseDetails.java", "Java", 76, 10, 17, 103
"c:\Users\zipasink\OneDrive\PhD\research\research-workspace\interactive-auto-mapping-tool\test-systems\teammates\src\main\java\teammates\common\datatransfer\questions\FeedbackMsqQuestionDetails.java", "Java", 497, 15, 90, 602
"c:\Users\zipasink\OneDrive\PhD\research\research-workspace\interactive-auto-mapping-tool\test-systems\teammates\src\main\java\teammates\common\datatransfer\questions\FeedbackMsqResponseDetails.java", "Java", 93, 2, 23, 118
"c:\Users\zipasink\OneDrive\PhD\research\research-workspace\interactive-auto-mapping-tool\test-systems\teammates\src\main\java\teammates\common\datatransfer\questions\FeedbackNumericalScaleQuestionDetails.java", "Java", 628, 35, 123, 786
"c:\Users\zipasink\OneDrive\PhD\research\research-workspace\interactive-auto-mapping-tool\test-systems\teammates\src\main\java\teammates\common\datatransfer\questions\FeedbackNumericalScaleResponseDetails.java", "Java", 39, 3, 13, 55
"c:\Users\zipasink\OneDrive\PhD\research\research-workspace\interactive-auto-mapping-tool\test-systems\teammates\src\main\java\teammates\common\datatransfer\questions\FeedbackQuestionDetails.java", "Java", 153, 59, 46, 258
"c:\Users\zipasink\OneDrive\PhD\research\research-workspace\interactive-auto-mapping-tool\test-systems\teammates\src\main\java\teammates\common\datatransfer\questions\FeedbackQuestionType.java", "Java", 139, 31, 19, 189
"c:\Users\zipasink\OneDrive\PhD\research\research-workspace\interactive-auto-mapping-tool\test-systems\teammates\src\main\java\teammates\common\datatransfer\questions\FeedbackRankOptionsQuestionDetails.java", "Java", 334, 8, 76, 418
"c:\Users\zipasink\OneDrive\PhD\research\research-workspace\interactive-auto-mapping-tool\test-systems\teammates\src\main\java\teammates\common\datatransfer\questions\FeedbackRankOptionsResponseDetails.java", "Java", 110, 3, 30, 143
"c:\Users\zipasink\OneDrive\PhD\research\research-workspace\interactive-auto-mapping-tool\test-systems\teammates\src\main\java\teammates\common\datatransfer\questions\FeedbackRankQuestionDetails.java", "Java", 106, 16, 31, 153
"c:\Users\zipasink\OneDrive\PhD\research\research-workspace\interactive-auto-mapping-tool\test-systems\teammates\src\main\java\teammates\common\datatransfer\questions\FeedbackRankRecipientsQuestionDetails.java", "Java", 344, 38, 82, 464
"c:\Users\zipasink\OneDrive\PhD\research\research-workspace\interactive-auto-mapping-tool\test-systems\teammates\src\main\java\teammates\common\datatransfer\questions\FeedbackRankRecipientsResponseDetails.java", "Java", 30, 0, 11, 41
"c:\Users\zipasink\OneDrive\PhD\research\research-workspace\interactive-auto-mapping-tool\test-systems\teammates\src\main\java\teammates\common\datatransfer\questions\FeedbackRankResponseDetails.java", "Java", 6, 0, 2, 8
"c:\Users\zipasink\OneDrive\PhD\research\research-workspace\interactive-auto-mapping-tool\test-systems\teammates\src\main\java\teammates\common\datatransfer\questions\FeedbackResponseDetails.java", "Java", 36, 21, 14, 71
"c:\Users\zipasink\OneDrive\PhD\research\research-workspace\interactive-auto-mapping-tool\test-systems\teammates\src\main\java\teammates\common\datatransfer\questions\FeedbackRubricQuestionDetails.java", "Java", 784, 94, 159, 1037
"c:\Users\zipasink\OneDrive\PhD\research\research-workspace\interactive-auto-mapping-tool\test-systems\teammates\src\main\java\teammates\common\datatransfer\questions\FeedbackRubricResponseDetails.java", "Java", 122, 17, 38, 177
"c:\Users\zipasink\OneDrive\PhD\research\research-workspace\interactive-auto-mapping-tool\test-systems\teammates\src\main\java\teammates\common\datatransfer\questions\FeedbackTextQuestionDetails.java", "Java", 132, 28, 26, 186
"c:\Users\zipasink\OneDrive\PhD\research\research-workspace\interactive-auto-mapping-tool\test-systems\teammates\src\main\java\teammates\common\datatransfer\questions\FeedbackTextResponseDetails.java", "Java", 32, 1, 12, 45
"c:\Users\zipasink\OneDrive\PhD\research\research-workspace\interactive-auto-mapping-tool\test-systems\teammates\src\main\java\teammates\common\datatransfer\questions\package-info.java", "Java", 1, 3, 1, 5
"c:\Users\zipasink\OneDrive\PhD\research\research-workspace\interactive-auto-mapping-tool\test-systems\teammates\src\main\java\teammates\common\exception\EmailSendingException.java", "Java", 7, 0, 4, 11
"c:\Users\zipasink\OneDrive\PhD\research\research-workspace\interactive-auto-mapping-tool\test-systems\teammates\src\main\java\teammates\common\exception\EnrollException.java", "Java", 10, 0, 3, 13
"c:\Users\zipasink\OneDrive\PhD\research\research-workspace\interactive-auto-mapping-tool\test-systems\teammates\src\main\java\teammates\common\exception\EntityAlreadyExistsException.java", "Java", 7, 0, 2, 9
"c:\Users\zipasink\OneDrive\PhD\research\research-workspace\interactive-auto-mapping-tool\test-systems\teammates\src\main\java\teammates\common\exception\EntityDoesNotExistException.java", "Java", 10, 0, 3, 13
"c:\Users\zipasink\OneDrive\PhD\research\research-workspace\interactive-auto-mapping-tool\test-systems\teammates\src\main\java\teammates\common\exception\EntityNotFoundException.java", "Java", 7, 0, 4, 11
"c:\Users\zipasink\OneDrive\PhD\research\research-workspace\interactive-auto-mapping-tool\test-systems\teammates\src\main\java\teammates\common\exception\ExceedingRangeException.java", "Java", 7, 0, 3, 10
"c:\Users\zipasink\OneDrive\PhD\research\research-workspace\interactive-auto-mapping-tool\test-systems\teammates\src\main\java\teammates\common\exception\FeedbackSessionNotVisibleException.java", "Java", 16, 0, 6, 22
"c:\Users\zipasink\OneDrive\PhD\research\research-workspace\interactive-auto-mapping-tool\test-systems\teammates\src\main\java\teammates\common\exception\InvalidOriginException.java", "Java", 10, 0, 3, 13
"c:\Users\zipasink\OneDrive\PhD\research\research-workspace\interactive-auto-mapping-tool\test-systems\teammates\src\main\java\teammates\common\exception\InvalidParametersException.java", "Java", 18, 0, 8, 26
"c:\Users\zipasink\OneDrive\PhD\research\research-workspace\interactive-auto-mapping-tool\test-systems\teammates\src\main\java\teammates\common\exception\JoinCourseException.java", "Java", 13, 0, 4, 17
"c:\Users\zipasink\OneDrive\PhD\research\research-workspace\interactive-auto-mapping-tool\test-systems\teammates\src\main\java\teammates\common\exception\NullPostParameterException.java", "Java", 7, 0, 2, 9
"c:\Users\zipasink\OneDrive\PhD\research\research-workspace\interactive-auto-mapping-tool\test-systems\teammates\src\main\java\teammates\common\exception\PageNotFoundException.java", "Java", 7, 0, 2, 9
"c:\Users\zipasink\OneDrive\PhD\research\research-workspace\interactive-auto-mapping-tool\test-systems\teammates\src\main\java\teammates\common\exception\TeammatesException.java", "Java", 26, 0, 9, 35
"c:\Users\zipasink\OneDrive\PhD\research\research-workspace\interactive-auto-mapping-tool\test-systems\teammates\src\main\java\teammates\common\exception\UnauthorizedAccessException.java", "Java", 10, 0, 3, 13
"c:\Users\zipasink\OneDrive\PhD\research\research-workspace\interactive-auto-mapping-tool\test-systems\teammates\src\main\java\teammates\common\exception\package-info.java", "Java", 1, 3, 1, 5
"c:\Users\zipasink\OneDrive\PhD\research\research-workspace\interactive-auto-mapping-tool\test-systems\teammates\src\main\java\teammates\common\util\Activity.java", "Java", 4, 6, 2, 12
"c:\Users\zipasink\OneDrive\PhD\research\research-workspace\interactive-auto-mapping-tool\test-systems\teammates\src\main\java\teammates\common\util\ActivityLogEntry.java", "Java", 214, 42, 53, 309
"c:\Users\zipasink\OneDrive\PhD\research\research-workspace\interactive-auto-mapping-tool\test-systems\teammates\src\main\java\teammates\common\util\AdminLogQuery.java", "Java", 43, 37, 13, 93
"c:\Users\zipasink\OneDrive\PhD\research\research-workspace\interactive-auto-mapping-tool\test-systems\teammates\src\main\java\teammates\common\util\AppUrl.java", "Java", 34, 3, 13, 50
"c:\Users\zipasink\OneDrive\PhD\research\research-workspace\interactive-auto-mapping-tool\test-systems\teammates\src\main\java\teammates\common\util\Assumption.java", "Java", 191, 146, 54, 391
"c:\Users\zipasink\OneDrive\PhD\research\research-workspace\interactive-auto-mapping-tool\test-systems\teammates\src\main\java\teammates\common\util\Config.java", "Java", 72, 37, 30, 139
"c:\Users\zipasink\OneDrive\PhD\research\research-workspace\interactive-auto-mapping-tool\test-systems\teammates\src\main\java\teammates\common\util\Const.java", "Java", 1270, 61, 219, 1550
"c:\Users\zipasink\OneDrive\PhD\research\research-workspace\interactive-auto-mapping-tool\test-systems\teammates\src\main\java\teammates\common\util\CryptoHelper.java", "Java", 25, 8, 5, 38
"c:\Users\zipasink\OneDrive\PhD\research\research-workspace\interactive-auto-mapping-tool\test-systems\teammates\src\main\java\teammates\common\util\EmailLogEntry.java", "Java", 49, 9, 17, 75
"c:\Users\zipasink\OneDrive\PhD\research\research-workspace\interactive-auto-mapping-tool\test-systems\teammates\src\main\java\teammates\common\util\EmailType.java", "Java", 24, 6, 7, 37
"c:\Users\zipasink\OneDrive\PhD\research\research-workspace\interactive-auto-mapping-tool\test-systems\teammates\src\main\java\teammates\common\util\EmailWrapper.java", "Java", 57, 3, 19, 79
"c:\Users\zipasink\OneDrive\PhD\research\research-workspace\interactive-auto-mapping-tool\test-systems\teammates\src\main\java\teammates\common\util\FieldValidator.java", "Java", 455, 216, 100, 771
"c:\Users\zipasink\OneDrive\PhD\research\research-workspace\interactive-auto-mapping-tool\test-systems\teammates\src\main\java\teammates\common\util\FileHelper.java", "Java", 19, 13, 7, 39
"c:\Users\zipasink\OneDrive\PhD\research\research-workspace\interactive-auto-mapping-tool\test-systems\teammates\src\main\java\teammates\common\util\FrontEndLibrary.java", "Java", 56, 4, 11, 71
"c:\Users\zipasink\OneDrive\PhD\research\research-workspace\interactive-auto-mapping-tool\test-systems\teammates\src\main\java\teammates\common\util\GaeLogApi.java", "Java", 17, 9, 4, 30
"c:\Users\zipasink\OneDrive\PhD\research\research-workspace\interactive-auto-mapping-tool\test-systems\teammates\src\main\java\teammates\common\util\GaeVersionApi.java", "Java", 45, 17, 10, 72
"c:\Users\zipasink\OneDrive\PhD\research\research-workspace\interactive-auto-mapping-tool\test-systems\teammates\src\main\java\teammates\common\util\GoogleCloudStorageHelper.java", "Java", 93, 61, 32, 186
"c:\Users\zipasink\OneDrive\PhD\research\research-workspace\interactive-auto-mapping-tool\test-systems\teammates\src\main\java\teammates\common\util\HttpRequestHelper.java", "Java", 67, 31, 18, 116
"c:\Users\zipasink\OneDrive\PhD\research\research-workspace\interactive-auto-mapping-tool\test-systems\teammates\src\main\java\teammates\common\util\JsonUtils.java", "Java", 62, 34, 16, 112
"c:\Users\zipasink\OneDrive\PhD\research\research-workspace\interactive-auto-mapping-tool\test-systems\teammates\src\main\java\teammates\common\util\LogMessageGenerator.java", "Java", 148, 40, 31, 219
"c:\Users\zipasink\OneDrive\PhD\research\research-workspace\interactive-auto-mapping-tool\test-systems\teammates\src\main\java\teammates\common\util\Logger.java", "Java", 23, 23, 10, 56
"c:\Users\zipasink\OneDrive\PhD\research\research-workspace\interactive-auto-mapping-tool\test-systems\teammates\src\main\java\teammates\common\util\NationalityHelper.java", "Java", 211, 14, 7, 232
"c:\Users\zipasink\OneDrive\PhD\research\research-workspace\interactive-auto-mapping-tool\test-systems\teammates\src\main\java\teammates\common\util\SanitizationHelper.java", "Java", 208, 147, 35, 390
"c:\Users\zipasink\OneDrive\PhD\research\research-workspace\interactive-auto-mapping-tool\test-systems\teammates\src\main\java\teammates\common\util\StatusMessage.java", "Java", 17, 4, 6, 27
"c:\Users\zipasink\OneDrive\PhD\research\research-workspace\interactive-auto-mapping-tool\test-systems\teammates\src\main\java\teammates\common\util\StatusMessageColor.java", "Java", 4, 3, 2, 9
"c:\Users\zipasink\OneDrive\PhD\research\research-workspace\interactive-auto-mapping-tool\test-systems\teammates\src\main\java\teammates\common\util\StringHelper.java", "Java", 353, 170, 85, 608
"c:\Users\zipasink\OneDrive\PhD\research\research-workspace\interactive-auto-mapping-tool\test-systems\teammates\src\main\java\teammates\common\util\TaskWrapper.java", "Java", 21, 3, 9, 33
"c:\Users\zipasink\OneDrive\PhD\research\research-workspace\interactive-auto-mapping-tool\test-systems\teammates\src\main\java\teammates\common\util\Templates.java", "Java", 387, 22, 27, 436
"c:\Users\zipasink\OneDrive\PhD\research\research-workspace\interactive-auto-mapping-tool\test-systems\teammates\src\main\java\teammates\common\util\ThreadHelper.java", "Java", 29, 4, 9, 42
"c:\Users\zipasink\OneDrive\PhD\research\research-workspace\interactive-auto-mapping-tool\test-systems\teammates\src\main\java\teammates\common\util\TimeHelper.java", "Java", 321, 110, 63, 494
"c:\Users\zipasink\OneDrive\PhD\research\research-workspace\interactive-auto-mapping-tool\test-systems\teammates\src\main\java\teammates\common\util\Url.java", "Java", 52, 59, 15, 126
"c:\Users\zipasink\OneDrive\PhD\research\research-workspace\interactive-auto-mapping-tool\test-systems\teammates\src\main\java\teammates\common\util\Version.java", "Java", 82, 48, 10, 140
"c:\Users\zipasink\OneDrive\PhD\research\research-workspace\interactive-auto-mapping-tool\test-systems\teammates\src\main\java\teammates\common\util\package-info.java", "Java", 1, 3, 1, 5
"c:\Users\zipasink\OneDrive\PhD\research\research-workspace\interactive-auto-mapping-tool\test-systems\teammates\src\main\java\teammates\common\util\retry\MaximumRetriesExceededException.java", "Java", 14, 6, 6, 26
"c:\Users\zipasink\OneDrive\PhD\research\research-workspace\interactive-auto-mapping-tool\test-systems\teammates\src\main\java\teammates\common\util\retry\RetryManager.java", "Java", 94, 47, 17, 158
"c:\Users\zipasink\OneDrive\PhD\research\research-workspace\interactive-auto-mapping-tool\test-systems\teammates\src\main\java\teammates\common\util\retry\Retryable.java", "Java", 17, 26, 10, 53
"c:\Users\zipasink\OneDrive\PhD\research\research-workspace\interactive-auto-mapping-tool\test-systems\teammates\src\main\java\teammates\common\util\retry\RetryableTask.java", "Java", 6, 3, 2, 11
"c:\Users\zipasink\OneDrive\PhD\research\research-workspace\interactive-auto-mapping-tool\test-systems\teammates\src\main\java\teammates\common\util\retry\RetryableTaskReturns.java", "Java", 6, 4, 2, 12
"c:\Users\zipasink\OneDrive\PhD\research\research-workspace\interactive-auto-mapping-tool\test-systems\teammates\src\main\java\teammates\common\util\retry\RetryableTaskReturnsThrows.java", "Java", 26, 14, 10, 50
"c:\Users\zipasink\OneDrive\PhD\research\research-workspace\interactive-auto-mapping-tool\test-systems\teammates\src\main\java\teammates\common\util\retry\RetryableTaskThrows.java", "Java", 19, 10, 7, 36
"c:\Users\zipasink\OneDrive\PhD\research\research-workspace\interactive-auto-mapping-tool\test-systems\teammates\src\main\java\teammates\common\util\retry\package-info.java", "Java", 1, 3, 1, 5
"c:\Users\zipasink\OneDrive\PhD\research\research-workspace\interactive-auto-mapping-tool\test-systems\teammates\src\main\java\teammates\logic\api\EmailGenerator.java", "Java", 496, 65, 104, 665
"c:\Users\zipasink\OneDrive\PhD\research\research-workspace\interactive-auto-mapping-tool\test-systems\teammates\src\main\java\teammates\logic\api\EmailSender.java", "Java", 53, 21, 16, 90
"c:\Users\zipasink\OneDrive\PhD\research\research-workspace\interactive-auto-mapping-tool\test-systems\teammates\src\main\java\teammates\logic\api\GateKeeper.java", "Java", 249, 44, 62, 355
"c:\Users\zipasink\OneDrive\PhD\research\research-workspace\interactive-auto-mapping-tool\test-systems\teammates\src\main\java\teammates\logic\api\Logic.java", "Java", 1044, 788, 369, 2201
"c:\Users\zipasink\OneDrive\PhD\research\research-workspace\interactive-auto-mapping-tool\test-systems\teammates\src\main\java\teammates\logic\api\TaskQueuer.java", "Java", 174, 103, 41, 318
"c:\Users\zipasink\OneDrive\PhD\research\research-workspace\interactive-auto-mapping-tool\test-systems\teammates\src\main\java\teammates\logic\api\package-info.java", "Java", 1, 3, 1, 5
"c:\Users\zipasink\OneDrive\PhD\research\research-workspace\interactive-auto-mapping-tool\test-systems\teammates\src\main\java\teammates\logic\backdoor\BackDoorLogic.java", "Java", 441, 69, 93, 603
"c:\Users\zipasink\OneDrive\PhD\research\research-workspace\interactive-auto-mapping-tool\test-systems\teammates\src\main\java\teammates\logic\backdoor\BackDoorOperation.java", "Java", 54, 42, 38, 134
"c:\Users\zipasink\OneDrive\PhD\research\research-workspace\interactive-auto-mapping-tool\test-systems\teammates\src\main\java\teammates\logic\backdoor\BackDoorServlet.java", "Java", 200, 12, 13, 225
"c:\Users\zipasink\OneDrive\PhD\research\research-workspace\interactive-auto-mapping-tool\test-systems\teammates\src\main\java\teammates\logic\backdoor\package-info.java", "Java", 1, 3, 1, 5
"c:\Users\zipasink\OneDrive\PhD\research\research-workspace\interactive-auto-mapping-tool\test-systems\teammates\src\main\java\teammates\logic\core\AccountsLogic.java", "Java", 252, 25, 72, 349
"c:\Users\zipasink\OneDrive\PhD\research\research-workspace\interactive-auto-mapping-tool\test-systems\teammates\src\main\java\teammates\logic\core\AdminEmailsLogic.java", "Java", 77, 53, 29, 159
"c:\Users\zipasink\OneDrive\PhD\research\research-workspace\interactive-auto-mapping-tool\test-systems\teammates\src\main\java\teammates\logic\core\CoursesLogic.java", "Java", 448, 147, 124, 719
"c:\Users\zipasink\OneDrive\PhD\research\research-workspace\interactive-auto-mapping-tool\test-systems\teammates\src\main\java\teammates\logic\core\EmailSenderService.java", "Java", 17, 12, 8, 37
"c:\Users\zipasink\OneDrive\PhD\research\research-workspace\interactive-auto-mapping-tool\test-systems\teammates\src\main\java\teammates\logic\core\FeedbackQuestionsLogic.java", "Java", 486, 122, 112, 720
"c:\Users\zipasink\OneDrive\PhD\research\research-workspace\interactive-auto-mapping-tool\test-systems\teammates\src\main\java\teammates\logic\core\FeedbackResponseCommentsLogic.java", "Java", 288, 29, 58, 375
"c:\Users\zipasink\OneDrive\PhD\research\research-workspace\interactive-auto-mapping-tool\test-systems\teammates\src\main\java\teammates\logic\core\FeedbackResponsesLogic.java", "Java", 653, 74, 129, 856
"c:\Users\zipasink\OneDrive\PhD\research\research-workspace\interactive-auto-mapping-tool\test-systems\teammates\src\main\java\teammates\logic\core\FeedbackSessionsLogic.java", "Java", 1789, 243, 392, 2424
"c:\Users\zipasink\OneDrive\PhD\research\research-workspace\interactive-auto-mapping-tool\test-systems\teammates\src\main\java\teammates\logic\core\InstructorsLogic.java", "Java", 191, 58, 76, 325
"c:\Users\zipasink\OneDrive\PhD\research\research-workspace\interactive-auto-mapping-tool\test-systems\teammates\src\main\java\teammates\logic\core\JavamailService.java", "Java", 37, 10, 8, 55
"c:\Users\zipasink\OneDrive\PhD\research\research-workspace\interactive-auto-mapping-tool\test-systems\teammates\src\main\java\teammates\logic\core\MailgunService.java", "Java", 42, 9, 15, 66
"c:\Users\zipasink\OneDrive\PhD\research\research-workspace\interactive-auto-mapping-tool\test-systems\teammates\src\main\java\teammates\logic\core\MailjetService.java", "Java", 42, 11, 11, 64
"c:\Users\zipasink\OneDrive\PhD\research\research-workspace\interactive-auto-mapping-tool\test-systems\teammates\src\main\java\teammates\logic\core\ProfilesLogic.java", "Java", 36, 8, 16, 60
"c:\Users\zipasink\OneDrive\PhD\research\research-workspace\interactive-auto-mapping-tool\test-systems\teammates\src\main\java\teammates\logic\core\SendgridService.java", "Java", 38, 9, 9, 56
"c:\Users\zipasink\OneDrive\PhD\research\research-workspace\interactive-auto-mapping-tool\test-systems\teammates\src\main\java\teammates\logic\core\StudentsLogic.java", "Java", 482, 59, 134, 675
"c:\Users\zipasink\OneDrive\PhD\research\research-workspace\interactive-auto-mapping-tool\test-systems\teammates\src\main\java\teammates\logic\core\TaskQueuesLogic.java", "Java", 26, 14, 11, 51
"c:\Users\zipasink\OneDrive\PhD\research\research-workspace\interactive-auto-mapping-tool\test-systems\teammates\src\main\java\teammates\logic\core\package-info.java", "Java", 1, 3, 1, 5
"c:\Users\zipasink\OneDrive\PhD\research\research-workspace\interactive-auto-mapping-tool\test-systems\teammates\src\main\java\teammates\storage\api\AccountsDb.java", "Java", 158, 41, 38, 237
"c:\Users\zipasink\OneDrive\PhD\research\research-workspace\interactive-auto-mapping-tool\test-systems\teammates\src\main\java\teammates\storage\api\AdminEmailsDb.java", "Java", 170, 42, 44, 256
"c:\Users\zipasink\OneDrive\PhD\research\research-workspace\interactive-auto-mapping-tool\test-systems\teammates\src\main\java\teammates\storage\api\CoursesDb.java", "Java", 86, 36, 31, 153
"c:\Users\zipasink\OneDrive\PhD\research\research-workspace\interactive-auto-mapping-tool\test-systems\teammates\src\main\java\teammates\storage\api\EntitiesDb.java", "Java", 247, 48, 64, 359
"c:\Users\zipasink\OneDrive\PhD\research\research-workspace\interactive-auto-mapping-tool\test-systems\teammates\src\main\java\teammates\storage\api\FeedbackQuestionsDb.java", "Java", 172, 63, 47, 282
"c:\Users\zipasink\OneDrive\PhD\research\research-workspace\interactive-auto-mapping-tool\test-systems\teammates\src\main\java\teammates\storage\api\FeedbackResponseCommentsDb.java", "Java", 299, 83, 83, 465
"c:\Users\zipasink\OneDrive\PhD\research\research-workspace\interactive-auto-mapping-tool\test-systems\teammates\src\main\java\teammates\storage\api\FeedbackResponsesDb.java", "Java", 456, 154, 120, 730
"c:\Users\zipasink\OneDrive\PhD\research\research-workspace\interactive-auto-mapping-tool\test-systems\teammates\src\main\java\teammates\storage\api\FeedbackSessionsDb.java", "Java", 330, 43, 101, 474
"c:\Users\zipasink\OneDrive\PhD\research\research-workspace\interactive-auto-mapping-tool\test-systems\teammates\src\main\java\teammates\storage\api\InstructorsDb.java", "Java", 268, 78, 78, 424
"c:\Users\zipasink\OneDrive\PhD\research\research-workspace\interactive-auto-mapping-tool\test-systems\teammates\src\main\java\teammates\storage\api\OfyHelper.java", "Java", 35, 8, 8, 51
"c:\Users\zipasink\OneDrive\PhD\research\research-workspace\interactive-auto-mapping-tool\test-systems\teammates\src\main\java\teammates\storage\api\ProfilesDb.java", "Java", 178, 52, 52, 282
"c:\Users\zipasink\OneDrive\PhD\research\research-workspace\interactive-auto-mapping-tool\test-systems\teammates\src\main\java\teammates\storage\api\StudentsDb.java", "Java", 395, 122, 98, 615
"c:\Users\zipasink\OneDrive\PhD\research\research-workspace\interactive-auto-mapping-tool\test-systems\teammates\src\main\java\teammates\storage\api\package-info.java", "Java", 1, 3, 1, 5
"c:\Users\zipasink\OneDrive\PhD\research\research-workspace\interactive-auto-mapping-tool\test-systems\teammates\src\main\java\teammates\storage\entity\Account.java", "Java", 103, 36, 31, 170
"c:\Users\zipasink\OneDrive\PhD\research\research-workspace\interactive-auto-mapping-tool\test-systems\teammates\src\main\java\teammates\storage\entity\AdminEmail.java", "Java", 80, 13, 29, 122
"c:\Users\zipasink\OneDrive\PhD\research\research-workspace\interactive-auto-mapping-tool\test-systems\teammates\src\main\java\teammates\storage\entity\BaseEntity.java", "Java", 3, 3, 2, 8
"c:\Users\zipasink\OneDrive\PhD\research\research-workspace\interactive-auto-mapping-tool\test-systems\teammates\src\main\java\teammates\storage\entity\Course.java", "Java", 56, 3, 19, 78
"c:\Users\zipasink\OneDrive\PhD\research\research-workspace\interactive-auto-mapping-tool\test-systems\teammates\src\main\java\teammates\storage\entity\CourseStudent.java", "Java", 145, 25, 49, 219
"c:\Users\zipasink\OneDrive\PhD\research\research-workspace\interactive-auto-mapping-tool\test-systems\teammates\src\main\java\teammates\storage\entity\FeedbackQuestion.java", "Java", 168, 13, 59, 240
"c:\Users\zipasink\OneDrive\PhD\research\research-workspace\interactive-auto-mapping-tool\test-systems\teammates\src\main\java\teammates\storage\entity\FeedbackResponse.java", "Java", 123, 11, 47, 181
"c:\Users\zipasink\OneDrive\PhD\research\research-workspace\interactive-auto-mapping-tool\test-systems\teammates\src\main\java\teammates\storage\entity\FeedbackResponseComment.java", "Java", 143, 26, 52, 221
"c:\Users\zipasink\OneDrive\PhD\research\research-workspace\interactive-auto-mapping-tool\test-systems\teammates\src\main\java\teammates\storage\entity\FeedbackSession.java", "Java", 255, 27, 79, 361
"c:\Users\zipasink\OneDrive\PhD\research\research-workspace\interactive-auto-mapping-tool\test-systems\teammates\src\main\java\teammates\storage\entity\Instructor.java", "Java", 141, 33, 44, 218
"c:\Users\zipasink\OneDrive\PhD\research\research-workspace\interactive-auto-mapping-tool\test-systems\teammates\src\main\java\teammates\storage\entity\StudentProfile.java", "Java", 111, 26, 37, 174
"c:\Users\zipasink\OneDrive\PhD\research\research-workspace\interactive-auto-mapping-tool\test-systems\teammates\src\main\java\teammates\storage\entity\package-info.java", "Java", 1, 3, 1, 5
"c:\Users\zipasink\OneDrive\PhD\research\research-workspace\interactive-auto-mapping-tool\test-systems\teammates\src\main\java\teammates\storage\search\FeedbackResponseCommentSearchDocument.java", "Java", 489, 28, 59, 576
"c:\Users\zipasink\OneDrive\PhD\research\research-workspace\interactive-auto-mapping-tool\test-systems\teammates\src\main\java\teammates\storage\search\FeedbackResponseCommentSearchQuery.java", "Java", 20, 5, 8, 33
"c:\Users\zipasink\OneDrive\PhD\research\research-workspace\interactive-auto-mapping-tool\test-systems\teammates\src\main\java\teammates\storage\search\InstructorSearchDocument.java", "Java", 85, 13, 25, 123
"c:\Users\zipasink\OneDrive\PhD\research\research-workspace\interactive-auto-mapping-tool\test-systems\teammates\src\main\java\teammates\storage\search\InstructorSearchQuery.java", "Java", 12, 9, 7, 28
"c:\Users\zipasink\OneDrive\PhD\research\research-workspace\interactive-auto-mapping-tool\test-systems\teammates\src\main\java\teammates\storage\search\SearchDocument.java", "Java", 53, 9, 13, 75
"c:\Users\zipasink\OneDrive\PhD\research\research-workspace\interactive-auto-mapping-tool\test-systems\teammates\src\main\java\teammates\storage\search\SearchManager.java", "Java", 150, 55, 32, 237
"c:\Users\zipasink\OneDrive\PhD\research\research-workspace\interactive-auto-mapping-tool\test-systems\teammates\src\main\java\teammates\storage\search\SearchQuery.java", "Java", 95, 9, 27, 131
"c:\Users\zipasink\OneDrive\PhD\research\research-workspace\interactive-auto-mapping-tool\test-systems\teammates\src\main\java\teammates\storage\search\StudentSearchDocument.java", "Java", 117, 19, 31, 167
"c:\Users\zipasink\OneDrive\PhD\research\research-workspace\interactive-auto-mapping-tool\test-systems\teammates\src\main\java\teammates\storage\search\StudentSearchQuery.java", "Java", 23, 9, 9, 41
"c:\Users\zipasink\OneDrive\PhD\research\research-workspace\interactive-auto-mapping-tool\test-systems\teammates\src\main\java\teammates\storage\search\package-info.java", "Java", 1, 3, 1, 5
"c:\Users\zipasink\OneDrive\PhD\research\research-workspace\interactive-auto-mapping-tool\test-systems\teammates\src\main\java\teammates\ui\automated\AdminPrepareEmailAddressModeWorkerAction.java", "Java", 39, 4, 14, 57
"c:\Users\zipasink\OneDrive\PhD\research\research-workspace\interactive-auto-mapping-tool\test-systems\teammates\src\main\java\teammates\ui\automated\AdminPrepareEmailGroupModeWorkerAction.java", "Java", 81, 4, 21, 106
"c:\Users\zipasink\OneDrive\PhD\research\research-workspace\interactive-auto-mapping-tool\test-systems\teammates\src\main\java\teammates\ui\automated\AdminSendEmailWorkerAction.java", "Java", 45, 3, 14, 62
"c:\Users\zipasink\OneDrive\PhD\research\research-workspace\interactive-auto-mapping-tool\test-systems\teammates\src\main\java\teammates\ui\automated\AutomatedAction.java", "Java", 54, 24, 20, 98
"c:\Users\zipasink\OneDrive\PhD\research\research-workspace\interactive-auto-mapping-tool\test-systems\teammates\src\main\java\teammates\ui\automated\AutomatedActionFactory.java", "Java", 55, 8, 15, 78
"c:\Users\zipasink\OneDrive\PhD\research\research-workspace\interactive-auto-mapping-tool\test-systems\teammates\src\main\java\teammates\ui\automated\AutomatedServlet.java", "Java", 35, 5, 11, 51
"c:\Users\zipasink\OneDrive\PhD\research\research-workspace\interactive-auto-mapping-tool\test-systems\teammates\src\main\java\teammates\ui\automated\CompileLogsAction.java", "Java", 56, 5, 18, 79
"c:\Users\zipasink\OneDrive\PhD\research\research-workspace\interactive-auto-mapping-tool\test-systems\teammates\src\main\java\teammates\ui\automated\FeedbackResponseAdjustmentWorkerAction.java", "Java", 58, 5, 17, 80
"c:\Users\zipasink\OneDrive\PhD\research\research-workspace\interactive-auto-mapping-tool\test-systems\teammates\src\main\java\teammates\ui\automated\FeedbackSessionClosedRemindersAction.java", "Java", 32, 3, 10, 45
"c:\Users\zipasink\OneDrive\PhD\research\research-workspace\interactive-auto-mapping-tool\test-systems\teammates\src\main\java\teammates\ui\automated\FeedbackSessionClosingRemindersAction.java", "Java", 32, 3, 10, 45
"c:\Users\zipasink\OneDrive\PhD\research\research-workspace\interactive-auto-mapping-tool\test-systems\teammates\src\main\java\teammates\ui\automated\FeedbackSessionOpeningRemindersAction.java", "Java", 32, 3, 10, 45
"c:\Users\zipasink\OneDrive\PhD\research\research-workspace\interactive-auto-mapping-tool\test-systems\teammates\src\main\java\teammates\ui\automated\FeedbackSessionPublishedEmailWorkerAction.java", "Java", 42, 3, 11, 56
"c:\Users\zipasink\OneDrive\PhD\research\research-workspace\interactive-auto-mapping-tool\test-systems\teammates\src\main\java\teammates\ui\automated\FeedbackSessionPublishedRemindersAction.java", "Java", 21, 3, 8, 32
"c:\Users\zipasink\OneDrive\PhD\research\research-workspace\interactive-auto-mapping-tool\test-systems\teammates\src\main\java\teammates\ui\automated\FeedbackSessionRemindEmailWorkerAction.java", "Java", 52, 4, 14, 70
"c:\Users\zipasink\OneDrive\PhD\research\research-workspace\interactive-auto-mapping-tool\test-systems\teammates\src\main\java\teammates\ui\automated\FeedbackSessionRemindParticularUsersEmailWorkerAction.java", "Java", 48, 3, 13, 64
"c:\Users\zipasink\OneDrive\PhD\research\research-workspace\interactive-auto-mapping-tool\test-systems\teammates\src\main\java\teammates\ui\automated\FeedbackSessionUnpublishedEmailWorkerAction.java", "Java", 42, 3, 11, 56
"c:\Users\zipasink\OneDrive\PhD\research\research-workspace\interactive-auto-mapping-tool\test-systems\teammates\src\main\java\teammates\ui\automated\InstructorCourseJoinEmailWorkerAction.java", "Java", 40, 3, 11, 54
"c:\Users\zipasink\OneDrive\PhD\research\research-workspace\interactive-auto-mapping-tool\test-systems\teammates\src\main\java\teammates\ui\automated\SendEmailWorkerAction.java", "Java", 46, 3, 15, 64
"c:\Users\zipasink\OneDrive\PhD\research\research-workspace\interactive-auto-mapping-tool\test-systems\teammates\src\main\java\teammates\ui\automated\StudentCourseJoinEmailWorkerAction.java", "Java", 39, 3, 9, 51
"c:\Users\zipasink\OneDrive\PhD\research\research-workspace\interactive-auto-mapping-tool\test-systems\teammates\src\main\java\teammates\ui\automated\package-info.java", "Java", 1, 3, 1, 5
"c:\Users\zipasink\OneDrive\PhD\research\research-workspace\interactive-auto-mapping-tool\test-systems\teammates\src\main\java\teammates\ui\controller\Action.java", "Java", 434, 160, 111, 705
"c:\Users\zipasink\OneDrive\PhD\research\research-workspace\interactive-auto-mapping-tool\test-systems\teammates\src\main\java\teammates\ui\controller\ActionFactory.java", "Java", 140, 8, 21, 169
"c:\Users\zipasink\OneDrive\PhD\research\research-workspace\interactive-auto-mapping-tool\test-systems\teammates\src\main\java\teammates\ui\controller\ActionResult.java", "Java", 65, 34, 23, 122
"c:\Users\zipasink\OneDrive\PhD\research\research-workspace\interactive-auto-mapping-tool\test-systems\teammates\src\main\java\teammates\ui\controller\AdminAccountDeleteAction.java", "Java", 44, 5, 11, 60
"c:\Users\zipasink\OneDrive\PhD\research\research-workspace\interactive-auto-mapping-tool\test-systems\teammates\src\main\java\teammates\ui\controller\AdminAccountDetailsPageAction.java", "Java", 34, 2, 12, 48
"c:\Users\zipasink\OneDrive\PhD\research\research-workspace\interactive-auto-mapping-tool\test-systems\teammates\src\main\java\teammates\ui\controller\AdminAccountManagementPageAction.java", "Java", 41, 0, 15, 56
"c:\Users\zipasink\OneDrive\PhD\research\research-workspace\interactive-auto-mapping-tool\test-systems\teammates\src\main\java\teammates\ui\controller\AdminActivityLogPageAction.java", "Java", 267, 34, 62, 363
"c:\Users\zipasink\OneDrive\PhD\research\research-workspace\interactive-auto-mapping-tool\test-systems\teammates\src\main\java\teammates\ui\controller\AdminEmailComposePageAction.java", "Java", 31, 0, 13, 44
"c:\Users\zipasink\OneDrive\PhD\research\research-workspace\interactive-auto-mapping-tool\test-systems\teammates\src\main\java\teammates\ui\controller\AdminEmailComposeSaveAction.java", "Java", 88, 6, 25, 119
"c:\Users\zipasink\OneDrive\PhD\research\research-workspace\interactive-auto-mapping-tool\test-systems\teammates\src\main\java\teammates\ui\controller\AdminEmailComposeSendAction.java", "Java", 154, 2, 35, 191
"c:\Users\zipasink\OneDrive\PhD\research\research-workspace\interactive-auto-mapping-tool\test-systems\teammates\src\main\java\teammates\ui\controller\AdminEmailCreateGroupReceiverListUploadUrlAction.java", "Java", 27, 0, 11, 38
"c:\Users\zipasink\OneDrive\PhD\research\research-workspace\interactive-auto-mapping-tool\test-systems\teammates\src\main\java\teammates\ui\controller\AdminEmailCreateImageUploadUrlAction.java", "Java", 20, 3, 7, 30
"c:\Users\zipasink\OneDrive\PhD\research\research-workspace\interactive-auto-mapping-tool\test-systems\teammates\src\main\java\teammates\ui\controller\AdminEmailDraftPageAction.java", "Java", 14, 0, 7, 21
"c:\Users\zipasink\OneDrive\PhD\research\research-workspace\interactive-auto-mapping-tool\test-systems\teammates\src\main\java\teammates\ui\controller\AdminEmailGroupReceiverListUploadAction.java", "Java", 95, 1, 27, 123
"c:\Users\zipasink\OneDrive\PhD\research\research-workspace\interactive-auto-mapping-tool\test-systems\teammates\src\main\java\teammates\ui\controller\AdminEmailImageUploadAction.java", "Java", 25, 3, 9, 37
"c:\Users\zipasink\OneDrive\PhD\research\research-workspace\interactive-auto-mapping-tool\test-systems\teammates\src\main\java\teammates\ui\controller\AdminEmailLogPageAction.java", "Java", 108, 20, 30, 158
"c:\Users\zipasink\OneDrive\PhD\research\research-workspace\interactive-auto-mapping-tool\test-systems\teammates\src\main\java\teammates\ui\controller\AdminEmailSentPageAction.java", "Java", 14, 0, 10, 24
"c:\Users\zipasink\OneDrive\PhD\research\research-workspace\interactive-auto-mapping-tool\test-systems\teammates\src\main\java\teammates\ui\controller\AdminEmailTrashAction.java", "Java", 50, 0, 16, 66
"c:\Users\zipasink\OneDrive\PhD\research\research-workspace\interactive-auto-mapping-tool\test-systems\teammates\src\main\java\teammates\ui\controller\AdminEmailTrashDeleteAction.java", "Java", 23, 0, 10, 33
"c:\Users\zipasink\OneDrive\PhD\research\research-workspace\interactive-auto-mapping-tool\test-systems\teammates\src\main\java\teammates\ui\controller\AdminEmailTrashPageAction.java", "Java", 14, 0, 7, 21
"c:\Users\zipasink\OneDrive\PhD\research\research-workspace\interactive-auto-mapping-tool\test-systems\teammates\src\main\java\teammates\ui\controller\AdminExceptionTestAction.java", "Java", 29, 0, 15, 44
"c:\Users\zipasink\OneDrive\PhD\research\research-workspace\interactive-auto-mapping-tool\test-systems\teammates\src\main\java\teammates\ui\controller\AdminHomePageAction.java", "Java", 16, 0, 10, 26
"c:\Users\zipasink\OneDrive\PhD\research\research-workspace\interactive-auto-mapping-tool\test-systems\teammates\src\main\java\teammates\ui\controller\AdminInstructorAccountAddAction.java", "Java", 160, 56, 39, 255
"c:\Users\zipasink\OneDrive\PhD\research\research-workspace\interactive-auto-mapping-tool\test-systems\teammates\src\main\java\teammates\ui\controller\AdminSearchPageAction.java", "Java", 270, 12, 90, 372
"c:\Users\zipasink\OneDrive\PhD\research\research-workspace\interactive-auto-mapping-tool\test-systems\teammates\src\main\java\teammates\ui\controller\AdminSessionsPageAction.java", "Java", 266, 5, 74, 345
"c:\Users\zipasink\OneDrive\PhD\research\research-workspace\interactive-auto-mapping-tool\test-systems\teammates\src\main\java\teammates\ui\controller\AdminStudentGoogleIdResetAction.java", "Java", 67, 7, 17, 91
"c:\Users\zipasink\OneDrive\PhD\research\research-workspace\interactive-auto-mapping-tool\test-systems\teammates\src\main\java\teammates\ui\controller\AjaxResult.java", "Java", 59, 11, 19, 89
"c:\Users\zipasink\OneDrive\PhD\research\research-workspace\interactive-auto-mapping-tool\test-systems\teammates\src\main\java\teammates\ui\controller\AppstatsFilter.java", "Java", 28, 7, 10, 45
"c:\Users\zipasink\OneDrive\PhD\research\research-workspace\interactive-auto-mapping-tool\test-systems\teammates\src\main\java\teammates\ui\controller\ControllerServlet.java", "Java", 119, 20, 26, 165
"c:\Users\zipasink\OneDrive\PhD\research\research-workspace\interactive-auto-mapping-tool\test-systems\teammates\src\main\java\teammates\ui\controller\CourseStatsPageAction.java", "Java", 16, 0, 8, 24
"c:\Users\zipasink\OneDrive\PhD\research\research-workspace\interactive-auto-mapping-tool\test-systems\teammates\src\main\java\teammates\ui\controller\CreateImageUploadUrlAction.java", "Java", 29, 3, 10, 42
"c:\Users\zipasink\OneDrive\PhD\research\research-workspace\interactive-auto-mapping-tool\test-systems\teammates\src\main\java\teammates\ui\controller\EntityModifiedLogsServlet.java", "Java", 53, 0, 14, 67
"c:\Users\zipasink\OneDrive\PhD\research\research-workspace\interactive-auto-mapping-tool\test-systems\teammates\src\main\java\teammates\ui\controller\FeedbackSessionStatsPageAction.java", "Java", 22, 0, 11, 33
"c:\Users\zipasink\OneDrive\PhD\research\research-workspace\interactive-auto-mapping-tool\test-systems\teammates\src\main\java\teammates\ui\controller\FeedbackSubmissionEditPageAction.java", "Java", 53, 0, 24, 77
"c:\Users\zipasink\OneDrive\PhD\research\research-workspace\interactive-auto-mapping-tool\test-systems\teammates\src\main\java\teammates\ui\controller\FeedbackSubmissionEditSaveAction.java", "Java", 302, 37, 73, 412
"c:\Users\zipasink\OneDrive\PhD\research\research-workspace\interactive-auto-mapping-tool\test-systems\teammates\src\main\java\teammates\ui\controller\FileDownloadResult.java", "Java", 50, 10, 15, 75
"c:\Users\zipasink\OneDrive\PhD\research\research-workspace\interactive-auto-mapping-tool\test-systems\teammates\src\main\java\teammates\ui\controller\ImageResult.java", "Java", 29, 1, 11, 41
"c:\Users\zipasink\OneDrive\PhD\research\research-workspace\interactive-auto-mapping-tool\test-systems\teammates\src\main\java\teammates\ui\controller\ImageUploadAction.java", "Java", 92, 15, 25, 132
"c:\Users\zipasink\OneDrive\PhD\research\research-workspace\interactive-auto-mapping-tool\test-systems\teammates\src\main\java\teammates\ui\controller\InstructorCourseAddAction.java", "Java", 85, 9, 23, 117
"c:\Users\zipasink\OneDrive\PhD\research\research-workspace\interactive-auto-mapping-tool\test-systems\teammates\src\main\java\teammates\ui\controller\InstructorCourseArchiveAction.java", "Java", 44, 4, 10, 58
"c:\Users\zipasink\OneDrive\PhD\research\research-workspace\interactive-auto-mapping-tool\test-systems\teammates\src\main\java\teammates\ui\controller\InstructorCourseDeleteAction.java", "Java", 27, 7, 9, 43
"c:\Users\zipasink\OneDrive\PhD\research\research-workspace\interactive-auto-mapping-tool\test-systems\teammates\src\main\java\teammates\ui\controller\InstructorCourseDetailsPageAction.java", "Java", 40, 5, 18, 63
"c:\Users\zipasink\OneDrive\PhD\research\research-workspace\interactive-auto-mapping-tool\test-systems\teammates\src\main\java\teammates\ui\controller\InstructorCourseEditPageAction.java", "Java", 43, 5, 16, 64
"c:\Users\zipasink\OneDrive\PhD\research\research-workspace\interactive-auto-mapping-tool\test-systems\teammates\src\main\java\teammates\ui\controller\InstructorCourseEditSaveAction.java", "Java", 35, 0, 10, 45
"c:\Users\zipasink\OneDrive\PhD\research\research-workspace\interactive-auto-mapping-tool\test-systems\teammates\src\main\java\teammates\ui\controller\InstructorCourseEnrollPageAction.java", "Java", 33, 4, 12, 49
"c:\Users\zipasink\OneDrive\PhD\research\research-workspace\interactive-auto-mapping-tool\test-systems\teammates\src\main\java\teammates\ui\controller\InstructorCourseEnrollSaveAction.java", "Java", 103, 13, 30, 146
"c:\Users\zipasink\OneDrive\PhD\research\research-workspace\interactive-auto-mapping-tool\test-systems\teammates\src\main\java\teammates\ui\controller\InstructorCourseInstructorAbstractAction.java", "Java", 187, 71, 25, 283
"c:\Users\zipasink\OneDrive\PhD\research\research-workspace\interactive-auto-mapping-tool\test-systems\teammates\src\main\java\teammates\ui\controller\InstructorCourseInstructorAddAction.java", "Java", 77, 26, 18, 121
"c:\Users\zipasink\OneDrive\PhD\research\research-workspace\interactive-auto-mapping-tool\test-systems\teammates\src\main\java\teammates\ui\controller\InstructorCourseInstructorDeleteAction.java", "Java", 53, 12, 17, 82
"c:\Users\zipasink\OneDrive\PhD\research\research-workspace\interactive-auto-mapping-tool\test-systems\teammates\src\main\java\teammates\ui\controller\InstructorCourseInstructorEditSaveAction.java", "Java", 103, 35, 20, 158
"c:\Users\zipasink\OneDrive\PhD\research\research-workspace\interactive-auto-mapping-tool\test-systems\teammates\src\main\java\teammates\ui\controller\InstructorCourseJoinAction.java", "Java", 29, 17, 15, 61
"c:\Users\zipasink\OneDrive\PhD\research\research-workspace\interactive-auto-mapping-tool\test-systems\teammates\src\main\java\teammates\ui\controller\InstructorCourseJoinAuthenticatedAction.java", "Java", 46, 11, 14, 71
"c:\Users\zipasink\OneDrive\PhD\research\research-workspace\interactive-auto-mapping-tool\test-systems\teammates\src\main\java\teammates\ui\controller\InstructorCourseRemindAction.java", "Java", 112, 7, 29, 148
"c:\Users\zipasink\OneDrive\PhD\research\research-workspace\interactive-auto-mapping-tool\test-systems\teammates\src\main\java\teammates\ui\controller\InstructorCourseStudentDeleteAction.java", "Java", 25, 0, 11, 36
"c:\Users\zipasink\OneDrive\PhD\research\research-workspace\interactive-auto-mapping-tool\test-systems\teammates\src\main\java\teammates\ui\controller\InstructorCourseStudentDeleteAllAction.java", "Java", 23, 0, 10, 33
"c:\Users\zipasink\OneDrive\PhD\research\research-workspace\interactive-auto-mapping-tool\test-systems\teammates\src\main\java\teammates\ui\controller\InstructorCourseStudentDetailsEditPageAction.java", "Java", 37, 0, 14, 51
"c:\Users\zipasink\OneDrive\PhD\research\research-workspace\interactive-auto-mapping-tool\test-systems\teammates\src\main\java\teammates\ui\controller\InstructorCourseStudentDetailsEditSaveAction.java", "Java", 101, 0, 26, 127
"c:\Users\zipasink\OneDrive\PhD\research\research-workspace\interactive-auto-mapping-tool\test-systems\teammates\src\main\java\teammates\ui\controller\InstructorCourseStudentDetailsPageAction.java", "Java", 60, 1, 16, 77
"c:\Users\zipasink\OneDrive\PhD\research\research-workspace\interactive-auto-mapping-tool\test-systems\teammates\src\main\java\teammates\ui\controller\InstructorCourseStudentListDownloadAction.java", "Java", 18, 0, 9, 27
"c:\Users\zipasink\OneDrive\PhD\research\research-workspace\interactive-auto-mapping-tool\test-systems\teammates\src\main\java\teammates\ui\controller\InstructorCoursesPageAction.java", "Java", 47, 20, 16, 83
"c:\Users\zipasink\OneDrive\PhD\research\research-workspace\interactive-auto-mapping-tool\test-systems\teammates\src\main\java\teammates\ui\controller\InstructorEditInstructorFeedbackPageAction.java", "Java", 49, 5, 17, 71
"c:\Users\zipasink\OneDrive\PhD\research\research-workspace\interactive-auto-mapping-tool\test-systems\teammates\src\main\java\teammates\ui\controller\InstructorEditInstructorFeedbackSaveAction.java", "Java", 134, 51, 30, 215
"c:\Users\zipasink\OneDrive\PhD\research\research-workspace\interactive-auto-mapping-tool\test-systems\teammates\src\main\java\teammates\ui\controller\InstructorEditStudentFeedbackPageAction.java", "Java", 59, 0, 21, 80
"c:\Users\zipasink\OneDrive\PhD\research\research-workspace\interactive-auto-mapping-tool\test-systems\teammates\src\main\java\teammates\ui\controller\InstructorEditStudentFeedbackSaveAction.java", "Java", 124, 4, 29, 157
"c:\Users\zipasink\OneDrive\PhD\research\research-workspace\interactive-auto-mapping-tool\test-systems\teammates\src\main\java\teammates\ui\controller\InstructorFeedbackAbstractAction.java", "Java", 130, 13, 24, 167
"c:\Users\zipasink\OneDrive\PhD\research\research-workspace\interactive-auto-mapping-tool\test-systems\teammates\src\main\java\teammates\ui\controller\InstructorFeedbackAddAction.java", "Java", 103, 11, 31, 145
"c:\Users\zipasink\OneDrive\PhD\research\research-workspace\interactive-auto-mapping-tool\test-systems\teammates\src\main\java\teammates\ui\controller\InstructorFeedbackCopyAction.java", "Java", 53, 2, 15, 70
"c:\Users\zipasink\OneDrive\PhD\research\research-workspace\interactive-auto-mapping-tool\test-systems\teammates\src\main\java\teammates\ui\controller\InstructorFeedbackDeleteAction.java", "Java", 28, 0, 11, 39
"c:\Users\zipasink\OneDrive\PhD\research\research-workspace\interactive-auto-mapping-tool\test-systems\teammates\src\main\java\teammates\ui\controller\InstructorFeedbackEditCopyAction.java", "Java", 104, 10, 25, 139
"c:\Users\zipasink\OneDrive\PhD\research\research-workspace\interactive-auto-mapping-tool\test-systems\teammates\src\main\java\teammates\ui\controller\InstructorFeedbackEditCopyPageAction.java", "Java", 33, 1, 16, 50
"c:\Users\zipasink\OneDrive\PhD\research\research-workspace\interactive-auto-mapping-tool\test-systems\teammates\src\main\java\teammates\ui\controller\InstructorFeedbackEditPageAction.java", "Java", 70, 0, 17, 87
"c:\Users\zipasink\OneDrive\PhD\research\research-workspace\interactive-auto-mapping-tool\test-systems\teammates\src\main\java\teammates\ui\controller\InstructorFeedbackEditSaveAction.java", "Java", 46, 2, 10, 58
"c:\Users\zipasink\OneDrive\PhD\research\research-workspace\interactive-auto-mapping-tool\test-systems\teammates\src\main\java\teammates\ui\controller\InstructorFeedbackPreviewAsInstructorAction.java", "Java", 42, 0, 14, 56
"c:\Users\zipasink\OneDrive\PhD\research\research-workspace\interactive-auto-mapping-tool\test-systems\teammates\src\main\java\teammates\ui\controller\InstructorFeedbackPreviewAsStudentAction.java", "Java", 40, 0, 14, 54
"c:\Users\zipasink\OneDrive\PhD\research\research-workspace\interactive-auto-mapping-tool\test-systems\teammates\src\main\java\teammates\ui\controller\InstructorFeedbackPublishAction.java", "Java", 39, 0, 10, 49
"c:\Users\zipasink\OneDrive\PhD\research\research-workspace\interactive-auto-mapping-tool\test-systems\teammates\src\main\java\teammates\ui\controller\InstructorFeedbackQuestionAddAction.java", "Java", 109, 0, 33, 142
"c:\Users\zipasink\OneDrive\PhD\research\research-workspace\interactive-auto-mapping-tool\test-systems\teammates\src\main\java\teammates\ui\controller\InstructorFeedbackQuestionCopyAction.java", "Java", 52, 2, 13, 67
"c:\Users\zipasink\OneDrive\PhD\research\research-workspace\interactive-auto-mapping-tool\test-systems\teammates\src\main\java\teammates\ui\controller\InstructorFeedbackQuestionCopyPageAction.java", "Java", 27, 0, 10, 37
"c:\Users\zipasink\OneDrive\PhD\research\research-workspace\interactive-auto-mapping-tool\test-systems\teammates\src\main\java\teammates\ui\controller\InstructorFeedbackQuestionEditAction.java", "Java", 162, 27, 46, 235
"c:\Users\zipasink\OneDrive\PhD\research\research-workspace\interactive-auto-mapping-tool\test-systems\teammates\src\main\java\teammates\ui\controller\InstructorFeedbackQuestionVisibilityMessageAction.java", "Java", 52, 0, 25, 77
"c:\Users\zipasink\OneDrive\PhD\research\research-workspace\interactive-auto-mapping-tool\test-systems\teammates\src\main\java\teammates\ui\controller\InstructorFeedbackRemindAction.java", "Java", 25, 0, 10, 35
"c:\Users\zipasink\OneDrive\PhD\research\research-workspace\interactive-auto-mapping-tool\test-systems\teammates\src\main\java\teammates\ui\controller\InstructorFeedbackRemindParticularStudentsAction.java", "Java", 34, 0, 10, 44
"c:\Users\zipasink\OneDrive\PhD\research\research-workspace\interactive-auto-mapping-tool\test-systems\teammates\src\main\java\teammates\ui\controller\InstructorFeedbackRemindParticularStudentsPageAction.java", "Java", 26, 0, 10, 36
"c:\Users\zipasink\OneDrive\PhD\research\research-workspace\interactive-auto-mapping-tool\test-systems\teammates\src\main\java\teammates\ui\controller\InstructorFeedbackResponseCommentAbstractAction.java", "Java", 24, 0, 4, 28
"c:\Users\zipasink\OneDrive\PhD\research\research-workspace\interactive-auto-mapping-tool\test-systems\teammates\src\main\java\teammates\ui\controller\InstructorFeedbackResponseCommentAddAction.java", "Java", 104, 5, 20, 129
"c:\Users\zipasink\OneDrive\PhD\research\research-workspace\interactive-auto-mapping-tool\test-systems\teammates\src\main\java\teammates\ui\controller\InstructorFeedbackResponseCommentDeleteAction.java", "Java", 37, 3, 11, 51
"c:\Users\zipasink\OneDrive\PhD\research\research-workspace\interactive-auto-mapping-tool\test-systems\teammates\src\main\java\teammates\ui\controller\InstructorFeedbackResponseCommentEditAction.java", "Java", 88, 8, 17, 113
"c:\Users\zipasink\OneDrive\PhD\research\research-workspace\interactive-auto-mapping-tool\test-systems\teammates\src\main\java\teammates\ui\controller\InstructorFeedbackResultsDownloadAction.java", "Java", 64, 1, 13, 78
"c:\Users\zipasink\OneDrive\PhD\research\research-workspace\interactive-auto-mapping-tool\test-systems\teammates\src\main\java\teammates\ui\controller\InstructorFeedbackResultsPageAction.java", "Java", 198, 16, 31, 245
"c:\Users\zipasink\OneDrive\PhD\research\research-workspace\interactive-auto-mapping-tool\test-systems\teammates\src\main\java\teammates\ui\controller\InstructorFeedbackSessionsPageAction.java", "Java", 50, 3, 15, 68
"c:\Users\zipasink\OneDrive\PhD\research\research-workspace\interactive-auto-mapping-tool\test-systems\teammates\src\main\java\teammates\ui\controller\InstructorFeedbackSubmissionEditPageAction.java", "Java", 58, 1, 14, 73
"c:\Users\zipasink\OneDrive\PhD\research\research-workspace\interactive-auto-mapping-tool\test-systems\teammates\src\main\java\teammates\ui\controller\InstructorFeedbackSubmissionEditSaveAction.java", "Java", 84, 1, 18, 103
"c:\Users\zipasink\OneDrive\PhD\research\research-workspace\interactive-auto-mapping-tool\test-systems\teammates\src\main\java\teammates\ui\controller\InstructorFeedbackUnpublishAction.java", "Java", 40, 0, 10, 50
"c:\Users\zipasink\OneDrive\PhD\research\research-workspace\interactive-auto-mapping-tool\test-systems\teammates\src\main\java\teammates\ui\controller\InstructorHomePageAction.java", "Java", 75, 0, 21, 96
"c:\Users\zipasink\OneDrive\PhD\research\research-workspace\interactive-auto-mapping-tool\test-systems\teammates\src\main\java\teammates\ui\controller\InstructorSearchPageAction.java", "Java", 56, 5, 16, 77
"c:\Users\zipasink\OneDrive\PhD\research\research-workspace\interactive-auto-mapping-tool\test-systems\teammates\src\main\java\teammates\ui\controller\InstructorStudentListAjaxPageAction.java", "Java", 54, 0, 15, 69
"c:\Users\zipasink\OneDrive\PhD\research\research-workspace\interactive-auto-mapping-tool\test-systems\teammates\src\main\java\teammates\ui\controller\InstructorStudentListPageAction.java", "Java", 53, 2, 17, 72
"c:\Users\zipasink\OneDrive\PhD\research\research-workspace\interactive-auto-mapping-tool\test-systems\teammates\src\main\java\teammates\ui\controller\InstructorStudentRecordsAjaxPageAction.java", "Java", 72, 0, 19, 91
"c:\Users\zipasink\OneDrive\PhD\research\research-workspace\interactive-auto-mapping-tool\test-systems\teammates\src\main\java\teammates\ui\controller\InstructorStudentRecordsPageAction.java", "Java", 82, 0, 22, 104
"c:\Users\zipasink\OneDrive\PhD\research\research-workspace\interactive-auto-mapping-tool\test-systems\teammates\src\main\java\teammates\ui\controller\LoginServlet.java", "Java", 47, 3, 9, 59
"c:\Users\zipasink\OneDrive\PhD\research\research-workspace\interactive-auto-mapping-tool\test-systems\teammates\src\main\java\teammates\ui\controller\LogoutServlet.java", "Java", 37, 3, 8, 48
"c:\Users\zipasink\OneDrive\PhD\research\research-workspace\interactive-auto-mapping-tool\test-systems\teammates\src\main\java\teammates\ui\controller\PublicImageServlet.java", "Java", 57, 5, 14, 76
"c:\Users\zipasink\OneDrive\PhD\research\research-workspace\interactive-auto-mapping-tool\test-systems\teammates\src\main\java\teammates\ui\controller\RedirectResult.java", "Java", 19, 3, 8, 30
"c:\Users\zipasink\OneDrive\PhD\research\research-workspace\interactive-auto-mapping-tool\test-systems\teammates\src\main\java\teammates\ui\controller\ShowPageResult.java", "Java", 44, 17, 14, 75
"c:\Users\zipasink\OneDrive\PhD\research\research-workspace\interactive-auto-mapping-tool\test-systems\teammates\src\main\java\teammates\ui\controller\StudentCourseDetailsPageAction.java", "Java", 27, 0, 12, 39
"c:\Users\zipasink\OneDrive\PhD\research\research-workspace\interactive-auto-mapping-tool\test-systems\teammates\src\main\java\teammates\ui\controller\StudentCourseJoinAction.java", "Java", 65, 23, 16, 104
"c:\Users\zipasink\OneDrive\PhD\research\research-workspace\interactive-auto-mapping-tool\test-systems\teammates\src\main\java\teammates\ui\controller\StudentCourseJoinAuthenticatedAction.java", "Java", 82, 10, 24, 116
"c:\Users\zipasink\OneDrive\PhD\research\research-workspace\interactive-auto-mapping-tool\test-systems\teammates\src\main\java\teammates\ui\controller\StudentFeedbackResultsPageAction.java", "Java", 57, 2, 15, 74
"c:\Users\zipasink\OneDrive\PhD\research\research-workspace\interactive-auto-mapping-tool\test-systems\teammates\src\main\java\teammates\ui\controller\StudentFeedbackSubmissionEditPageAction.java", "Java", 60, 5, 14, 79
"c:\Users\zipasink\OneDrive\PhD\research\research-workspace\interactive-auto-mapping-tool\test-systems\teammates\src\main\java\teammates\ui\controller\StudentFeedbackSubmissionEditSaveAction.java", "Java", 88, 9, 22, 119
"c:\Users\zipasink\OneDrive\PhD\research\research-workspace\interactive-auto-mapping-tool\test-systems\teammates\src\main\java\teammates\ui\controller\StudentHomePageAction.java", "Java", 99, 0, 28, 127
"c:\Users\zipasink\OneDrive\PhD\research\research-workspace\interactive-auto-mapping-tool\test-systems\teammates\src\main\java\teammates\ui\controller\StudentProfileCreateFormUrlAction.java", "Java", 33, 6, 8, 47
"c:\Users\zipasink\OneDrive\PhD\research\research-workspace\interactive-auto-mapping-tool\test-systems\teammates\src\main\java\teammates\ui\controller\StudentProfileEditSaveAction.java", "Java", 59, 5, 11, 75
"c:\Users\zipasink\OneDrive\PhD\research\research-workspace\interactive-auto-mapping-tool\test-systems\teammates\src\main\java\teammates\ui\controller\StudentProfilePageAction.java", "Java", 24, 3, 9, 36
"c:\Users\zipasink\OneDrive\PhD\research\research-workspace\interactive-auto-mapping-tool\test-systems\teammates\src\main\java\teammates\ui\controller\StudentProfilePictureAction.java", "Java", 85, 5, 20, 110
"c:\Users\zipasink\OneDrive\PhD\research\research-workspace\interactive-auto-mapping-tool\test-systems\teammates\src\main\java\teammates\ui\controller\StudentProfilePictureEditAction.java", "Java", 165, 17, 28, 210
"c:\Users\zipasink\OneDrive\PhD\research\research-workspace\interactive-auto-mapping-tool\test-systems\teammates\src\main\java\teammates\ui\controller\StudentProfilePictureUploadAction.java", "Java", 108, 18, 17, 143
"c:\Users\zipasink\OneDrive\PhD\research\research-workspace\interactive-auto-mapping-tool\test-systems\teammates\src\main\java\teammates\ui\controller\package-info.java", "Java", 1, 3, 1, 5
"c:\Users\zipasink\OneDrive\PhD\research\research-workspace\interactive-auto-mapping-tool\test-systems\teammates\src\main\java\teammates\ui\datatransfer\InstructorFeedbackResultsPageViewType.java", "Java", 27, 1, 8, 36
"c:\Users\zipasink\OneDrive\PhD\research\research-workspace\interactive-auto-mapping-tool\test-systems\teammates\src\main\java\teammates\ui\datatransfer\InstructorStudentListPageCourseData.java", "Java", 13, 4, 6, 23
"c:\Users\zipasink\OneDrive\PhD\research\research-workspace\interactive-auto-mapping-tool\test-systems\teammates\src\main\java\teammates\ui\datatransfer\package-info.java", "Java", 1, 4, 1, 6
"c:\Users\zipasink\OneDrive\PhD\research\research-workspace\interactive-auto-mapping-tool\test-systems\teammates\src\main\java\teammates\ui\pagedata\AdminAccountDetailsPageData.java", "Java", 55, 0, 15, 70
"c:\Users\zipasink\OneDrive\PhD\research\research-workspace\interactive-auto-mapping-tool\test-systems\teammates\src\main\java\teammates\ui\pagedata\AdminAccountManagementPageData.java", "Java", 42, 1, 14, 57
"c:\Users\zipasink\OneDrive\PhD\research\research-workspace\interactive-auto-mapping-tool\test-systems\teammates\src\main\java\teammates\ui\pagedata\AdminActivityLogPageData.java", "Java", 359, 50, 90, 499
"c:\Users\zipasink\OneDrive\PhD\research\research-workspace\interactive-auto-mapping-tool\test-systems\teammates\src\main\java\teammates\ui\pagedata\AdminEmailComposePageData.java", "Java", 17, 0, 7, 24
"c:\Users\zipasink\OneDrive\PhD\research\research-workspace\interactive-auto-mapping-tool\test-systems\teammates\src\main\java\teammates\ui\pagedata\AdminEmailCreateGroupReceiverListUploadUrlAjaxPageData.java", "Java", 11, 0, 5, 16
"c:\Users\zipasink\OneDrive\PhD\research\research-workspace\interactive-auto-mapping-tool\test-systems\teammates\src\main\java\teammates\ui\pagedata\AdminEmailDraftPageData.java", "Java", 11, 0, 6, 17
"c:\Users\zipasink\OneDrive\PhD\research\research-workspace\interactive-auto-mapping-tool\test-systems\teammates\src\main\java\teammates\ui\pagedata\AdminEmailLogPageData.java", "Java", 227, 32, 58, 317
"c:\Users\zipasink\OneDrive\PhD\research\research-workspace\interactive-auto-mapping-tool\test-systems\teammates\src\main\java\teammates\ui\pagedata\AdminEmailPageData.java", "Java", 145, 3, 44, 192
"c:\Users\zipasink\OneDrive\PhD\research\research-workspace\interactive-auto-mapping-tool\test-systems\teammates\src\main\java\teammates\ui\pagedata\AdminEmailSentPageData.java", "Java", 11, 0, 6, 17
"c:\Users\zipasink\OneDrive\PhD\research\research-workspace\interactive-auto-mapping-tool\test-systems\teammates\src\main\java\teammates\ui\pagedata\AdminEmailTrashPageData.java", "Java", 19, 0, 6, 25
"c:\Users\zipasink\OneDrive\PhD\research\research-workspace\interactive-auto-mapping-tool\test-systems\teammates\src\main\java\teammates\ui\pagedata\AdminHomePageData.java", "Java", 25, 0, 9, 34
"c:\Users\zipasink\OneDrive\PhD\research\research-workspace\interactive-auto-mapping-tool\test-systems\teammates\src\main\java\teammates\ui\pagedata\AdminSearchPageData.java", "Java", 186, 20, 45, 251
"c:\Users\zipasink\OneDrive\PhD\research\research-workspace\interactive-auto-mapping-tool\test-systems\teammates\src\main\java\teammates\ui\pagedata\AdminSessionsPageData.java", "Java", 174, 0, 30, 204
"c:\Users\zipasink\OneDrive\PhD\research\research-workspace\interactive-auto-mapping-tool\test-systems\teammates\src\main\java\teammates\ui\pagedata\AdminStudentGoogleIdResetPageData.java", "Java", 9, 3, 5, 17
"c:\Users\zipasink\OneDrive\PhD\research\research-workspace\interactive-auto-mapping-tool\test-systems\teammates\src\main\java\teammates\ui\pagedata\CourseStatsPageData.java", "Java", 9, 0, 4, 13
"c:\Users\zipasink\OneDrive\PhD\research\research-workspace\interactive-auto-mapping-tool\test-systems\teammates\src\main\java\teammates\ui\pagedata\CreateImageUploadUrlAjaxPageData.java", "Java", 9, 3, 4, 16
"c:\Users\zipasink\OneDrive\PhD\research\research-workspace\interactive-auto-mapping-tool\test-systems\teammates\src\main\java\teammates\ui\pagedata\FeedbackSessionStatsPageData.java", "Java", 9, 0, 4, 13
"c:\Users\zipasink\OneDrive\PhD\research\research-workspace\interactive-auto-mapping-tool\test-systems\teammates\src\main\java\teammates\ui\pagedata\FeedbackSubmissionEditPageData.java", "Java", 203, 14, 55, 272
"c:\Users\zipasink\OneDrive\PhD\research\research-workspace\interactive-auto-mapping-tool\test-systems\teammates\src\main\java\teammates\ui\pagedata\FileUploadPageData.java", "Java", 10, 3, 5, 18
"c:\Users\zipasink\OneDrive\PhD\research\research-workspace\interactive-auto-mapping-tool\test-systems\teammates\src\main\java\teammates\ui\pagedata\InstructorCourseDetailsPageData.java", "Java", 122, 3, 26, 151
"c:\Users\zipasink\OneDrive\PhD\research\research-workspace\interactive-auto-mapping-tool\test-systems\teammates\src\main\java\teammates\ui\pagedata\InstructorCourseEditPageData.java", "Java", 200, 7, 46, 253
"c:\Users\zipasink\OneDrive\PhD\research\research-workspace\interactive-auto-mapping-tool\test-systems\teammates\src\main\java\teammates\ui\pagedata\InstructorCourseEnrollPageData.java", "Java", 21, 3, 7, 31
"c:\Users\zipasink\OneDrive\PhD\research\research-workspace\interactive-auto-mapping-tool\test-systems\teammates\src\main\java\teammates\ui\pagedata\InstructorCourseEnrollResultPageData.java", "Java", 97, 3, 18, 118
"c:\Users\zipasink\OneDrive\PhD\research\research-workspace\interactive-auto-mapping-tool\test-systems\teammates\src\main\java\teammates\ui\pagedata\InstructorCourseJoinConfirmationPageData.java", "Java", 26, 0, 9, 35
"c:\Users\zipasink\OneDrive\PhD\research\research-workspace\interactive-auto-mapping-tool\test-systems\teammates\src\main\java\teammates\ui\pagedata\InstructorCourseStudentDetailsEditPageData.java", "Java", 25, 0, 8, 33
"c:\Users\zipasink\OneDrive\PhD\research\research-workspace\interactive-auto-mapping-tool\test-systems\teammates\src\main\java\teammates\ui\pagedata\InstructorCourseStudentDetailsPageData.java", "Java", 25, 0, 8, 33
"c:\Users\zipasink\OneDrive\PhD\research\research-workspace\interactive-auto-mapping-tool\test-systems\teammates\src\main\java\teammates\ui\pagedata\InstructorCoursesPageData.java", "Java", 141, 5, 43, 189
"c:\Users\zipasink\OneDrive\PhD\research\research-workspace\interactive-auto-mapping-tool\test-systems\teammates\src\main\java\teammates\ui\pagedata\InstructorFeedbackEditCopyData.java", "Java", 22, 11, 6, 39
"c:\Users\zipasink\OneDrive\PhD\research\research-workspace\interactive-auto-mapping-tool\test-systems\teammates\src\main\java\teammates\ui\pagedata\InstructorFeedbackEditCopyPageData.java", "Java", 25, 0, 8, 33
"c:\Users\zipasink\OneDrive\PhD\research\research-workspace\interactive-auto-mapping-tool\test-systems\teammates\src\main\java\teammates\ui\pagedata\InstructorFeedbackEditPageData.java", "Java", 286, 12, 74, 372
"c:\Users\zipasink\OneDrive\PhD\research\research-workspace\interactive-auto-mapping-tool\test-systems\teammates\src\main\java\teammates\ui\pagedata\InstructorFeedbackQuestionCopyPageData.java", "Java", 35, 0, 14, 49
"c:\Users\zipasink\OneDrive\PhD\research\research-workspace\interactive-auto-mapping-tool\test-systems\teammates\src\main\java\teammates\ui\pagedata\InstructorFeedbackQuestionVisibilityMessagePageData.java", "Java", 9, 0, 5, 14
"c:\Users\zipasink\OneDrive\PhD\research\research-workspace\interactive-auto-mapping-tool\test-systems\teammates\src\main\java\teammates\ui\pagedata\InstructorFeedbackRemindParticularStudentsPageData.java", "Java", 25, 0, 7, 32
"c:\Users\zipasink\OneDrive\PhD\research\research-workspace\interactive-auto-mapping-tool\test-systems\teammates\src\main\java\teammates\ui\pagedata\InstructorFeedbackResponseCommentAjaxPageData.java", "Java", 85, 3, 13, 101
"c:\Users\zipasink\OneDrive\PhD\research\research-workspace\interactive-auto-mapping-tool\test-systems\teammates\src\main\java\teammates\ui\pagedata\InstructorFeedbackResultsPageData.java", "Java", 1338, 118, 294, 1750
"c:\Users\zipasink\OneDrive\PhD\research\research-workspace\interactive-auto-mapping-tool\test-systems\teammates\src\main\java\teammates\ui\pagedata\InstructorFeedbackSessionsPageData.java", "Java", 209, 41, 60, 310
"c:\Users\zipasink\OneDrive\PhD\research\research-workspace\interactive-auto-mapping-tool\test-systems\teammates\src\main\java\teammates\ui\pagedata\InstructorHomeCourseAjaxPageData.java", "Java", 113, 0, 29, 142
"c:\Users\zipasink\OneDrive\PhD\research\research-workspace\interactive-auto-mapping-tool\test-systems\teammates\src\main\java\teammates\ui\pagedata\InstructorHomePageData.java", "Java", 41, 10, 13, 64
"c:\Users\zipasink\OneDrive\PhD\research\research-workspace\interactive-auto-mapping-tool\test-systems\teammates\src\main\java\teammates\ui\pagedata\InstructorSearchPageData.java", "Java", 213, 10, 49, 272
"c:\Users\zipasink\OneDrive\PhD\research\research-workspace\interactive-auto-mapping-tool\test-systems\teammates\src\main\java\teammates\ui\pagedata\InstructorStudentListAjaxPageData.java", "Java", 47, 0, 11, 58
"c:\Users\zipasink\OneDrive\PhD\research\research-workspace\interactive-auto-mapping-tool\test-systems\teammates\src\main\java\teammates\ui\pagedata\InstructorStudentListPageData.java", "Java", 52, 1, 12, 65
"c:\Users\zipasink\OneDrive\PhD\research\research-workspace\interactive-auto-mapping-tool\test-systems\teammates\src\main\java\teammates\ui\pagedata\InstructorStudentRecordsAjaxPageData.java", "Java", 23, 0, 8, 31
"c:\Users\zipasink\OneDrive\PhD\research\research-workspace\interactive-auto-mapping-tool\test-systems\teammates\src\main\java\teammates\ui\pagedata\InstructorStudentRecordsPageData.java", "Java", 47, 0, 13, 60
"c:\Users\zipasink\OneDrive\PhD\research\research-workspace\interactive-auto-mapping-tool\test-systems\teammates\src\main\java\teammates\ui\pagedata\PageData.java", "Java", 639, 111, 112, 862
"c:\Users\zipasink\OneDrive\PhD\research\research-workspace\interactive-auto-mapping-tool\test-systems\teammates\src\main\java\teammates\ui\pagedata\StudentCourseDetailsPageData.java", "Java", 36, 1, 10, 47
"c:\Users\zipasink\OneDrive\PhD\research\research-workspace\interactive-auto-mapping-tool\test-systems\teammates\src\main\java\teammates\ui\pagedata\StudentCourseJoinConfirmationPageData.java", "Java", 35, 0, 10, 45
"c:\Users\zipasink\OneDrive\PhD\research\research-workspace\interactive-auto-mapping-tool\test-systems\teammates\src\main\java\teammates\ui\pagedata\StudentFeedbackResultsPageData.java", "Java", 164, 38, 42, 244
"c:\Users\zipasink\OneDrive\PhD\research\research-workspace\interactive-auto-mapping-tool\test-systems\teammates\src\main\java\teammates\ui\pagedata\StudentHomePageData.java", "Java", 103, 18, 22, 143
"c:\Users\zipasink\OneDrive\PhD\research\research-workspace\interactive-auto-mapping-tool\test-systems\teammates\src\main\java\teammates\ui\pagedata\StudentProfileCreateFormUrlAjaxPageData.java", "Java", 12, 0, 6, 18
"c:\Users\zipasink\OneDrive\PhD\research\research-workspace\interactive-auto-mapping-tool\test-systems\teammates\src\main\java\teammates\ui\pagedata\StudentProfilePageData.java", "Java", 31, 0, 9, 40
"c:\Users\zipasink\OneDrive\PhD\research\research-workspace\interactive-auto-mapping-tool\test-systems\teammates\src\main\java\teammates\ui\pagedata\package-info.java", "Java", 1, 3, 1, 5
"c:\Users\zipasink\OneDrive\PhD\research\research-workspace\interactive-auto-mapping-tool\test-systems\teammates\src\main\java\teammates\ui\template\ActiveCoursesTable.java", "Java", 15, 0, 6, 21
"c:\Users\zipasink\OneDrive\PhD\research\research-workspace\interactive-auto-mapping-tool\test-systems\teammates\src\main\java\teammates\ui\template\ActiveCoursesTableRow.java", "Java", 27, 0, 9, 36
"c:\Users\zipasink\OneDrive\PhD\research\research-workspace\interactive-auto-mapping-tool\test-systems\teammates\src\main\java\teammates\ui\template\AdminAccountDetailsInstructorCourseListTableRow.java", "Java", 36, 0, 9, 45
"c:\Users\zipasink\OneDrive\PhD\research\research-workspace\interactive-auto-mapping-tool\test-systems\teammates\src\main\java\teammates\ui\template\AdminAccountDetailsStudentCourseListTableRow.java", "Java", 36, 0, 9, 45
"c:\Users\zipasink\OneDrive\PhD\research\research-workspace\interactive-auto-mapping-tool\test-systems\teammates\src\main\java\teammates\ui\template\AdminAccountManagementAccountTableRow.java", "Java", 50, 0, 12, 62
"c:\Users\zipasink\OneDrive\PhD\research\research-workspace\interactive-auto-mapping-tool\test-systems\teammates\src\main\java\teammates\ui\template\AdminActivityLogTableRow.java", "Java", 120, 4, 40, 164
"c:\Users\zipasink\OneDrive\PhD\research\research-workspace\interactive-auto-mapping-tool\test-systems\teammates\src\main\java\teammates\ui\template\AdminDraftEmailRow.java", "Java", 36, 0, 9, 45
"c:\Users\zipasink\OneDrive\PhD\research\research-workspace\interactive-auto-mapping-tool\test-systems\teammates\src\main\java\teammates\ui\template\AdminDraftEmailTable.java", "Java", 16, 0, 6, 22
"c:\Users\zipasink\OneDrive\PhD\research\research-workspace\interactive-auto-mapping-tool\test-systems\teammates\src\main\java\teammates\ui\template\AdminEmailActions.java", "Java", 31, 0, 10, 41
"c:\Users\zipasink\OneDrive\PhD\research\research-workspace\interactive-auto-mapping-tool\test-systems\teammates\src\main\java\teammates\ui\template\AdminEmailTableRow.java", "Java", 34, 2, 14, 50
"c:\Users\zipasink\OneDrive\PhD\research\research-workspace\interactive-auto-mapping-tool\test-systems\teammates\src\main\java\teammates\ui\template\AdminFeedbackSessionRow.java", "Java", 51, 0, 13, 64
"c:\Users\zipasink\OneDrive\PhD\research\research-workspace\interactive-auto-mapping-tool\test-systems\teammates\src\main\java\teammates\ui\template\AdminFilter.java", "Java", 44, 0, 11, 55
"c:\Users\zipasink\OneDrive\PhD\research\research-workspace\interactive-auto-mapping-tool\test-systems\teammates\src\main\java\teammates\ui\template\AdminSearchInstructorRow.java", "Java", 57, 0, 13, 70
"c:\Users\zipasink\OneDrive\PhD\research\research-workspace\interactive-auto-mapping-tool\test-systems\teammates\src\main\java\teammates\ui\template\AdminSearchInstructorTable.java", "Java", 11, 0, 5, 16
"c:\Users\zipasink\OneDrive\PhD\research\research-workspace\interactive-auto-mapping-tool\test-systems\teammates\src\main\java\teammates\ui\template\AdminSearchStudentFeedbackSession.java", "Java", 15, 0, 5, 20
"c:\Users\zipasink\OneDrive\PhD\research\research-workspace\interactive-auto-mapping-tool\test-systems\teammates\src\main\java\teammates\ui\template\AdminSearchStudentLinks.java", "Java", 20, 0, 6, 26
"c:\Users\zipasink\OneDrive\PhD\research\research-workspace\interactive-auto-mapping-tool\test-systems\teammates\src\main\java\teammates\ui\template\AdminSearchStudentRow.java", "Java", 87, 0, 21, 108
"c:\Users\zipasink\OneDrive\PhD\research\research-workspace\interactive-auto-mapping-tool\test-systems\teammates\src\main\java\teammates\ui\template\AdminSearchStudentTable.java", "Java", 11, 0, 5, 16
"c:\Users\zipasink\OneDrive\PhD\research\research-workspace\interactive-auto-mapping-tool\test-systems\teammates\src\main\java\teammates\ui\template\AdminSentEmailRow.java", "Java", 36, 0, 9, 45
"c:\Users\zipasink\OneDrive\PhD\research\research-workspace\interactive-auto-mapping-tool\test-systems\teammates\src\main\java\teammates\ui\template\AdminSentEmailTable.java", "Java", 16, 0, 6, 22
"c:\Users\zipasink\OneDrive\PhD\research\research-workspace\interactive-auto-mapping-tool\test-systems\teammates\src\main\java\teammates\ui\template\AdminTrashEmailActions.java", "Java", 30, 0, 11, 41
"c:\Users\zipasink\OneDrive\PhD\research\research-workspace\interactive-auto-mapping-tool\test-systems\teammates\src\main\java\teammates\ui\template\AdminTrashEmailRow.java", "Java", 36, 0, 9, 45
"c:\Users\zipasink\OneDrive\PhD\research\research-workspace\interactive-auto-mapping-tool\test-systems\teammates\src\main\java\teammates\ui\template\AdminTrashEmailTable.java", "Java", 25, 0, 8, 33
"c:\Users\zipasink\OneDrive\PhD\research\research-workspace\interactive-auto-mapping-tool\test-systems\teammates\src\main\java\teammates\ui\template\ArchivedCoursesTable.java", "Java", 15, 0, 6, 21
"c:\Users\zipasink\OneDrive\PhD\research\research-workspace\interactive-auto-mapping-tool\test-systems\teammates\src\main\java\teammates\ui\template\ArchivedCoursesTableRow.java", "Java", 21, 0, 7, 28
"c:\Users\zipasink\OneDrive\PhD\research\research-workspace\interactive-auto-mapping-tool\test-systems\teammates\src\main\java\teammates\ui\template\CourseEditFeedbackSessionRow.java", "Java", 16, 0, 6, 22
"c:\Users\zipasink\OneDrive\PhD\research\research-workspace\interactive-auto-mapping-tool\test-systems\teammates\src\main\java\teammates\ui\template\CourseEditInstructorPanel.java", "Java", 185, 14, 52, 251
"c:\Users\zipasink\OneDrive\PhD\research\research-workspace\interactive-auto-mapping-tool\test-systems\teammates\src\main\java\teammates\ui\template\CourseEditSectionRow.java", "Java", 135, 35, 34, 204
"c:\Users\zipasink\OneDrive\PhD\research\research-workspace\interactive-auto-mapping-tool\test-systems\teammates\src\main\java\teammates\ui\template\CourseTable.java", "Java", 28, 1, 9, 38
"c:\Users\zipasink\OneDrive\PhD\research\research-workspace\interactive-auto-mapping-tool\test-systems\teammates\src\main\java\teammates\ui\template\ElementTag.java", "Java", 57, 25, 16, 98
"c:\Users\zipasink\OneDrive\PhD\research\research-workspace\interactive-auto-mapping-tool\test-systems\teammates\src\main\java\teammates\ui\template\EnrollResultPanel.java", "Java", 23, 0, 8, 31
"c:\Users\zipasink\OneDrive\PhD\research\research-workspace\interactive-auto-mapping-tool\test-systems\teammates\src\main\java\teammates\ui\template\FeedbackQuestionCopyTable.java", "Java", 11, 3, 6, 20
"c:\Users\zipasink\OneDrive\PhD\research\research-workspace\interactive-auto-mapping-tool\test-systems\teammates\src\main\java\teammates\ui\template\FeedbackQuestionEditForm.java", "Java", 168, 5, 61, 234
"c:\Users\zipasink\OneDrive\PhD\research\research-workspace\interactive-auto-mapping-tool\test-systems\teammates\src\main\java\teammates\ui\template\FeedbackQuestionFeedbackPathSettings.java", "Java", 39, 5, 16, 60
"c:\Users\zipasink\OneDrive\PhD\research\research-workspace\interactive-auto-mapping-tool\test-systems\teammates\src\main\java\teammates\ui\template\FeedbackQuestionTableRow.java", "Java", 30, 3, 9, 42
"c:\Users\zipasink\OneDrive\PhD\research\research-workspace\interactive-auto-mapping-tool\test-systems\teammates\src\main\java\teammates\ui\template\FeedbackQuestionVisibilitySettings.java", "Java", 51, 0, 14, 65
"c:\Users\zipasink\OneDrive\PhD\research\research-workspace\interactive-auto-mapping-tool\test-systems\teammates\src\main\java\teammates\ui\template\FeedbackResponseCommentRow.java", "Java", 206, 2, 57, 265
"c:\Users\zipasink\OneDrive\PhD\research\research-workspace\interactive-auto-mapping-tool\test-systems\teammates\src\main\java\teammates\ui\template\FeedbackResponsePersonRow.java", "Java", 24, 0, 9, 33
"c:\Users\zipasink\OneDrive\PhD\research\research-workspace\interactive-auto-mapping-tool\test-systems\teammates\src\main\java\teammates\ui\template\FeedbackResponseRow.java", "Java", 125, 3, 17, 145
"c:\Users\zipasink\OneDrive\PhD\research\research-workspace\interactive-auto-mapping-tool\test-systems\teammates\src\main\java\teammates\ui\template\FeedbackResultsQuestionDetails.java", "Java", 32, 0, 9, 41
"c:\Users\zipasink\OneDrive\PhD\research\research-workspace\interactive-auto-mapping-tool\test-systems\teammates\src\main\java\teammates\ui\template\FeedbackResultsResponse.java", "Java", 22, 0, 7, 29
"c:\Users\zipasink\OneDrive\PhD\research\research-workspace\interactive-auto-mapping-tool\test-systems\teammates\src\main\java\teammates\ui\template\FeedbackResultsResponseTable.java", "Java", 19, 0, 7, 26
"c:\Users\zipasink\OneDrive\PhD\research\research-workspace\interactive-auto-mapping-tool\test-systems\teammates\src\main\java\teammates\ui\template\FeedbackResultsTable.java", "Java", 44, 0, 12, 56
"c:\Users\zipasink\OneDrive\PhD\research\research-workspace\interactive-auto-mapping-tool\test-systems\teammates\src\main\java\teammates\ui\template\FeedbackSessionPreviewForm.java", "Java", 39, 3, 15, 57
"c:\Users\zipasink\OneDrive\PhD\research\research-workspace\interactive-auto-mapping-tool\test-systems\teammates\src\main\java\teammates\ui\template\FeedbackSessionPublishButton.java", "Java", 59, 0, 23, 82
"c:\Users\zipasink\OneDrive\PhD\research\research-workspace\interactive-auto-mapping-tool\test-systems\teammates\src\main\java\teammates\ui\template\FeedbackSessionRow.java", "Java", 22, 0, 7, 29
"c:\Users\zipasink\OneDrive\PhD\research\research-workspace\interactive-auto-mapping-tool\test-systems\teammates\src\main\java\teammates\ui\template\FeedbackSessionsAdditionalSettingsFormSegment.java", "Java", 152, 0, 43, 195
"c:\Users\zipasink\OneDrive\PhD\research\research-workspace\interactive-auto-mapping-tool\test-systems\teammates\src\main\java\teammates\ui\template\FeedbackSessionsCopyFromModal.java", "Java", 23, 8, 8, 39
"c:\Users\zipasink\OneDrive\PhD\research\research-workspace\interactive-auto-mapping-tool\test-systems\teammates\src\main\java\teammates\ui\template\FeedbackSessionsForm.java", "Java", 184, 8, 73, 265
"c:\Users\zipasink\OneDrive\PhD\research\research-workspace\interactive-auto-mapping-tool\test-systems\teammates\src\main\java\teammates\ui\template\FeedbackSessionsTable.java", "Java", 23, 0, 10, 33
"c:\Users\zipasink\OneDrive\PhD\research\research-workspace\interactive-auto-mapping-tool\test-systems\teammates\src\main\java\teammates\ui\template\FeedbackSessionsTableRow.java", "Java", 41, 8, 12, 61
"c:\Users\zipasink\OneDrive\PhD\research\research-workspace\interactive-auto-mapping-tool\test-systems\teammates\src\main\java\teammates\ui\template\FeedbackSubmissionEditQuestion.java", "Java", 100, 0, 25, 125
"c:\Users\zipasink\OneDrive\PhD\research\research-workspace\interactive-auto-mapping-tool\test-systems\teammates\src\main\java\teammates\ui\template\FeedbackSubmissionEditResponse.java", "Java", 32, 0, 10, 42
"c:\Users\zipasink\OneDrive\PhD\research\research-workspace\interactive-auto-mapping-tool\test-systems\teammates\src\main\java\teammates\ui\template\HomeFeedbackSessionRow.java", "Java", 20, 0, 6, 26
"c:\Users\zipasink\OneDrive\PhD\research\research-workspace\interactive-auto-mapping-tool\test-systems\teammates\src\main\java\teammates\ui\template\InstitutionPanel.java", "Java", 16, 0, 6, 22
"c:\Users\zipasink\OneDrive\PhD\research\research-workspace\interactive-auto-mapping-tool\test-systems\teammates\src\main\java\teammates\ui\template\InstructorFeedbackResponseComment.java", "Java", 39, 0, 10, 49
"c:\Users\zipasink\OneDrive\PhD\research\research-workspace\interactive-auto-mapping-tool\test-systems\teammates\src\main\java\teammates\ui\template\InstructorFeedbackResultsFilterPanel.java", "Java", 65, 0, 17, 82
"c:\Users\zipasink\OneDrive\PhD\research\research-workspace\interactive-auto-mapping-tool\test-systems\teammates\src\main\java\teammates\ui\template\InstructorFeedbackResultsGroupByParticipantPanel.java", "Java", 12, 5, 6, 23
"c:\Users\zipasink\OneDrive\PhD\research\research-workspace\interactive-auto-mapping-tool\test-systems\teammates\src\main\java\teammates\ui\template\InstructorFeedbackResultsGroupByQuestionPanel.java", "Java", 43, 10, 15, 68
"c:\Users\zipasink\OneDrive\PhD\research\research-workspace\interactive-auto-mapping-tool\test-systems\teammates\src\main\java\teammates\ui\template\InstructorFeedbackResultsModerationButton.java", "Java", 49, 4, 14, 67
"c:\Users\zipasink\OneDrive\PhD\research\research-workspace\interactive-auto-mapping-tool\test-systems\teammates\src\main\java\teammates\ui\template\InstructorFeedbackResultsNoResponsePanel.java", "Java", 75, 1, 19, 95
"c:\Users\zipasink\OneDrive\PhD\research\research-workspace\interactive-auto-mapping-tool\test-systems\teammates\src\main\java\teammates\ui\template\InstructorFeedbackResultsParticipantPanel.java", "Java", 59, 1, 21, 81
"c:\Users\zipasink\OneDrive\PhD\research\research-workspace\interactive-auto-mapping-tool\test-systems\teammates\src\main\java\teammates\ui\template\InstructorFeedbackResultsQuestionTable.java", "Java", 114, 2, 43, 159
"c:\Users\zipasink\OneDrive\PhD\research\research-workspace\interactive-auto-mapping-tool\test-systems\teammates\src\main\java\teammates\ui\template\InstructorFeedbackResultsRemindButton.java", "Java", 37, 3, 11, 51
"c:\Users\zipasink\OneDrive\PhD\research\research-workspace\interactive-auto-mapping-tool\test-systems\teammates\src\main\java\teammates\ui\template\InstructorFeedbackResultsResponsePanel.java", "Java", 91, 1, 27, 119
"c:\Users\zipasink\OneDrive\PhD\research\research-workspace\interactive-auto-mapping-tool\test-systems\teammates\src\main\java\teammates\ui\template\InstructorFeedbackResultsResponseRow.java", "Java", 125, 3, 42, 170
"c:\Users\zipasink\OneDrive\PhD\research\research-workspace\interactive-auto-mapping-tool\test-systems\teammates\src\main\java\teammates\ui\template\InstructorFeedbackResultsSecondaryParticipantPanelBody.java", "Java", 38, 3, 15, 56
"c:\Users\zipasink\OneDrive\PhD\research\research-workspace\interactive-auto-mapping-tool\test-systems\teammates\src\main\java\teammates\ui\template\InstructorFeedbackResultsSectionPanel.java", "Java", 130, 9, 42, 181
"c:\Users\zipasink\OneDrive\PhD\research\research-workspace\interactive-auto-mapping-tool\test-systems\teammates\src\main\java\teammates\ui\template\InstructorFeedbackResultsSessionPanel.java", "Java", 81, 0, 15, 96
"c:\Users\zipasink\OneDrive\PhD\research\research-workspace\interactive-auto-mapping-tool\test-systems\teammates\src\main\java\teammates\ui\template\InstructorFeedbackSessionActions.java", "Java", 99, 0, 32, 131
"c:\Users\zipasink\OneDrive\PhD\research\research-workspace\interactive-auto-mapping-tool\test-systems\teammates\src\main\java\teammates\ui\template\InstructorHomeFeedbackSessionRow.java", "Java", 38, 0, 10, 48
"c:\Users\zipasink\OneDrive\PhD\research\research-workspace\interactive-auto-mapping-tool\test-systems\teammates\src\main\java\teammates\ui\template\InstructorStudentListFilterBox.java", "Java", 17, 0, 8, 25
"c:\Users\zipasink\OneDrive\PhD\research\research-workspace\interactive-auto-mapping-tool\test-systems\teammates\src\main\java\teammates\ui\template\InstructorStudentListFilterCourse.java", "Java", 15, 0, 7, 22
"c:\Users\zipasink\OneDrive\PhD\research\research-workspace\interactive-auto-mapping-tool\test-systems\teammates\src\main\java\teammates\ui\template\InstructorStudentListSearchBox.java", "Java", 21, 0, 9, 30
"c:\Users\zipasink\OneDrive\PhD\research\research-workspace\interactive-auto-mapping-tool\test-systems\teammates\src\main\java\teammates\ui\template\InstructorStudentListStudentsTableCourse.java", "Java", 38, 0, 11, 49
"c:\Users\zipasink\OneDrive\PhD\research\research-workspace\interactive-auto-mapping-tool\test-systems\teammates\src\main\java\teammates\ui\template\QuestionTable.java", "Java", 27, 0, 8, 35
"c:\Users\zipasink\OneDrive\PhD\research\research-workspace\interactive-auto-mapping-tool\test-systems\teammates\src\main\java\teammates\ui\template\ResponseRow.java", "Java", 27, 0, 8, 35
"c:\Users\zipasink\OneDrive\PhD\research\research-workspace\interactive-auto-mapping-tool\test-systems\teammates\src\main\java\teammates\ui\template\SearchCommentsForResponsesTable.java", "Java", 11, 4, 6, 21
"c:\Users\zipasink\OneDrive\PhD\research\research-workspace\interactive-auto-mapping-tool\test-systems\teammates\src\main\java\teammates\ui\template\SearchStudentsTable.java", "Java", 26, 4, 8, 38
"c:\Users\zipasink\OneDrive\PhD\research\research-workspace\interactive-auto-mapping-tool\test-systems\teammates\src\main\java\teammates\ui\template\StudentCourseDetailsPanel.java", "Java", 45, 0, 13, 58
"c:\Users\zipasink\OneDrive\PhD\research\research-workspace\interactive-auto-mapping-tool\test-systems\teammates\src\main\java\teammates\ui\template\StudentFeedbackResultsQuestionWithResponses.java", "Java", 18, 0, 7, 25
"c:\Users\zipasink\OneDrive\PhD\research\research-workspace\interactive-auto-mapping-tool\test-systems\teammates\src\main\java\teammates\ui\template\StudentFeedbackSessionActions.java", "Java", 59, 0, 14, 73
"c:\Users\zipasink\OneDrive\PhD\research\research-workspace\interactive-auto-mapping-tool\test-systems\teammates\src\main\java\teammates\ui\template\StudentFeedbackSubmissionEditQuestionsWithResponses.java", "Java", 28, 0, 8, 36
"c:\Users\zipasink\OneDrive\PhD\research\research-workspace\interactive-auto-mapping-tool\test-systems\teammates\src\main\java\teammates\ui\template\StudentHomeFeedbackSessionRow.java", "Java", 22, 0, 6, 28
"c:\Users\zipasink\OneDrive\PhD\research\research-workspace\interactive-auto-mapping-tool\test-systems\teammates\src\main\java\teammates\ui\template\StudentInfoTable.java", "Java", 41, 0, 11, 52
"c:\Users\zipasink\OneDrive\PhD\research\research-workspace\interactive-auto-mapping-tool\test-systems\teammates\src\main\java\teammates\ui\template\StudentListSectionData.java", "Java", 36, 0, 12, 48
"c:\Users\zipasink\OneDrive\PhD\research\research-workspace\interactive-auto-mapping-tool\test-systems\teammates\src\main\java\teammates\ui\template\StudentListStudentData.java", "Java", 82, 0, 18, 100
"c:\Users\zipasink\OneDrive\PhD\research\research-workspace\interactive-auto-mapping-tool\test-systems\teammates\src\main\java\teammates\ui\template\StudentListTeamData.java", "Java", 28, 0, 9, 37
"c:\Users\zipasink\OneDrive\PhD\research\research-workspace\interactive-auto-mapping-tool\test-systems\teammates\src\main\java\teammates\ui\template\StudentProfile.java", "Java", 46, 0, 12, 58
"c:\Users\zipasink\OneDrive\PhD\research\research-workspace\interactive-auto-mapping-tool\test-systems\teammates\src\main\java\teammates\ui\template\StudentProfileEditBox.java", "Java", 70, 1, 19, 90
"c:\Users\zipasink\OneDrive\PhD\research\research-workspace\interactive-auto-mapping-tool\test-systems\teammates\src\main\java\teammates\ui\template\StudentProfileUploadPhotoModal.java", "Java", 20, 0, 8, 28
"c:\Users\zipasink\OneDrive\PhD\research\research-workspace\interactive-auto-mapping-tool\test-systems\teammates\src\main\java\teammates\ui\template\package-info.java", "Java", 1, 3, 1, 5
"Total", "-", 48972, 7962, 12308, 69242