"filename", "language", "Java", "comment", "blank", "total"
"c:\Users\zipasink\OneDrive\PhD\research\research-workspace\interactive-auto-mapping-tool\test-systems\ProM\sources\org\processmining\basicutils\help\LGPLLicenseHelp.java", "Java", 5, 0, 3, 8
"c:\Users\zipasink\OneDrive\PhD\research\research-workspace\interactive-auto-mapping-tool\test-systems\ProM\sources\org\processmining\basicutils\models\LGPLLicense.java", "Java", 60, 1, 9, 70
"c:\Users\zipasink\OneDrive\PhD\research\research-workspace\interactive-auto-mapping-tool\test-systems\ProM\sources\org\processmining\basicutils\models\ObjectArray.java", "Java", 15, 27, 11, 53
"c:\Users\zipasink\OneDrive\PhD\research\research-workspace\interactive-auto-mapping-tool\test-systems\ProM\sources\org\processmining\basicutils\models\impl\ObjectArrayImpl.java", "Java", 54, 0, 13, 67
"c:\Users\zipasink\OneDrive\PhD\research\research-workspace\interactive-auto-mapping-tool\test-systems\ProM\sources\org\processmining\basicutils\parameters\PluginParameters.java", "Java", 18, 0, 14, 32
"c:\Users\zipasink\OneDrive\PhD\research\research-workspace\interactive-auto-mapping-tool\test-systems\ProM\sources\org\processmining\basicutils\parameters\impl\PluginParametersImpl.java", "Java", 66, 0, 17, 83
"c:\Users\zipasink\OneDrive\PhD\research\research-workspace\interactive-auto-mapping-tool\test-systems\ProM\sources\org\processmining\basicutils\plugins\LGPLLicensePlugin.java", "Java", 19, 3, 5, 27
"c:\Users\zipasink\OneDrive\PhD\research\research-workspace\interactive-auto-mapping-tool\test-systems\ProM\sources\org\processmining\basicutils\utils\HTMLUtils.java", "Java", 6, 0, 3, 9
"c:\Users\zipasink\OneDrive\PhD\research\research-workspace\interactive-auto-mapping-tool\test-systems\ProM\sources\org\processmining\basicutils\utils\StringConstants.java", "Java", 5, 0, 4, 9
"c:\Users\zipasink\OneDrive\PhD\research\research-workspace\interactive-auto-mapping-tool\test-systems\ProM\sources\org\processmining\contexts\cli\CLI.java", "Java", 117, 31, 19, 167
"c:\Users\zipasink\OneDrive\PhD\research\research-workspace\interactive-auto-mapping-tool\test-systems\ProM\sources\org\processmining\contexts\cli\CLIContext.java", "Java", 18, 0, 9, 27
"c:\Users\zipasink\OneDrive\PhD\research\research-workspace\interactive-auto-mapping-tool\test-systems\ProM\sources\org\processmining\contexts\cli\CLIPluginContext.java", "Java", 43, 7, 12, 62
"c:\Users\zipasink\OneDrive\PhD\research\research-workspace\interactive-auto-mapping-tool\test-systems\ProM\sources\org\processmining\contexts\cli\CLIProgressBar.java", "Java", 8, 0, 4, 12
"c:\Users\zipasink\OneDrive\PhD\research\research-workspace\interactive-auto-mapping-tool\test-systems\ProM\sources\org\processmining\contexts\cli\PromTestException.java", "Java", 88, 17, 23, 128
"c:\Users\zipasink\OneDrive\PhD\research\research-workspace\interactive-auto-mapping-tool\test-systems\ProM\sources\org\processmining\contexts\cli\PromTestFramework.java", "Java", 279, 54, 55, 388
"c:\Users\zipasink\OneDrive\PhD\research\research-workspace\interactive-auto-mapping-tool\test-systems\ProM\sources\org\processmining\contexts\scripting\ScriptExecutor.java", "Java", 232, 65, 56, 353
"c:\Users\zipasink\OneDrive\PhD\research\research-workspace\interactive-auto-mapping-tool\test-systems\ProM\sources\org\processmining\contexts\scripting\Signature.java", "Java", 64, 0, 14, 78
"c:\Users\zipasink\OneDrive\PhD\research\research-workspace\interactive-auto-mapping-tool\test-systems\ProM\sources\org\processmining\contexts\test\AllInclassMethodTests.java", "Java", 239, 68, 48, 355
"c:\Users\zipasink\OneDrive\PhD\research\research-workspace\interactive-auto-mapping-tool\test-systems\ProM\sources\org\processmining\contexts\test\AllStandardScriptTests.java", "Java", 22, 9, 10, 41
"c:\Users\zipasink\OneDrive\PhD\research\research-workspace\interactive-auto-mapping-tool\test-systems\ProM\sources\org\processmining\contexts\test\InclassMethodTest.java", "Java", 77, 49, 24, 150
"c:\Users\zipasink\OneDrive\PhD\research\research-workspace\interactive-auto-mapping-tool\test-systems\ProM\sources\org\processmining\contexts\test\PromTest.java", "Java", 51, 31, 18, 100
"c:\Users\zipasink\OneDrive\PhD\research\research-workspace\interactive-auto-mapping-tool\test-systems\ProM\sources\org\processmining\contexts\test\StandardScriptTest.java", "Java", 19, 4, 9, 32
"c:\Users\zipasink\OneDrive\PhD\research\research-workspace\interactive-auto-mapping-tool\test-systems\ProM\sources\org\processmining\contexts\test\factory\FactoryRunner.java", "Java", 58, 39, 19, 116
"c:\Users\zipasink\OneDrive\PhD\research\research-workspace\interactive-auto-mapping-tool\test-systems\ProM\sources\org\processmining\contexts\test\factory\FactoryTest.java", "Java", 9, 14, 4, 27
"c:\Users\zipasink\OneDrive\PhD\research\research-workspace\interactive-auto-mapping-tool\test-systems\ProM\sources\org\processmining\contexts\test\factory\FrameworkFactoryTest.java", "Java", 20, 16, 8, 44
"c:\Users\zipasink\OneDrive\PhD\research\research-workspace\interactive-auto-mapping-tool\test-systems\ProM\sources\org\processmining\contexts\test\factory\TestFactory.java", "Java", 10, 17, 3, 30
"c:\Users\zipasink\OneDrive\PhD\research\research-workspace\interactive-auto-mapping-tool\test-systems\ProM\sources\org\processmining\contexts\uitopia\UI.java", "Java", 179, 17, 52, 248
"c:\Users\zipasink\OneDrive\PhD\research\research-workspace\interactive-auto-mapping-tool\test-systems\ProM\sources\org\processmining\contexts\uitopia\UIContext.java", "Java", 90, 4, 25, 119
"c:\Users\zipasink\OneDrive\PhD\research\research-workspace\interactive-auto-mapping-tool\test-systems\ProM\sources\org\processmining\contexts\uitopia\UIPluginContext.java", "Java", 103, 38, 31, 172
"c:\Users\zipasink\OneDrive\PhD\research\research-workspace\interactive-auto-mapping-tool\test-systems\ProM\sources\org\processmining\contexts\uitopia\annotations\UIExportPlugin.java", "Java", 12, 0, 5, 17
"c:\Users\zipasink\OneDrive\PhD\research\research-workspace\interactive-auto-mapping-tool\test-systems\ProM\sources\org\processmining\contexts\uitopia\annotations\UIImportPlugin.java", "Java", 12, 8, 6, 26
"c:\Users\zipasink\OneDrive\PhD\research\research-workspace\interactive-auto-mapping-tool\test-systems\ProM\sources\org\processmining\contexts\uitopia\annotations\UITopiaVariant.java", "Java", 19, 0, 12, 31
"c:\Users\zipasink\OneDrive\PhD\research\research-workspace\interactive-auto-mapping-tool\test-systems\ProM\sources\org\processmining\contexts\uitopia\annotations\Visualizer.java", "Java", 12, 5, 6, 23
"c:\Users\zipasink\OneDrive\PhD\research\research-workspace\interactive-auto-mapping-tool\test-systems\ProM\sources\org\processmining\contexts\uitopia\hub\ProMActionManager.java", "Java", 137, 18, 29, 184
"c:\Users\zipasink\OneDrive\PhD\research\research-workspace\interactive-auto-mapping-tool\test-systems\ProM\sources\org\processmining\contexts\uitopia\hub\ProMCategoryManager.java", "Java", 28, 0, 11, 39
"c:\Users\zipasink\OneDrive\PhD\research\research-workspace\interactive-auto-mapping-tool\test-systems\ProM\sources\org\processmining\contexts\uitopia\hub\ProMResourceManager.java", "Java", 645, 109, 114, 868
"c:\Users\zipasink\OneDrive\PhD\research\research-workspace\interactive-auto-mapping-tool\test-systems\ProM\sources\org\processmining\contexts\uitopia\hub\ProMTaskManager.java", "Java", 129, 1, 29, 159
"c:\Users\zipasink\OneDrive\PhD\research\research-workspace\interactive-auto-mapping-tool\test-systems\ProM\sources\org\processmining\contexts\uitopia\hub\ProMViewManager.java", "Java", 99, 0, 20, 119
"c:\Users\zipasink\OneDrive\PhD\research\research-workspace\interactive-auto-mapping-tool\test-systems\ProM\sources\org\processmining\contexts\uitopia\hub\UpdateSignaller.java", "Java", 38, 0, 11, 49
"c:\Users\zipasink\OneDrive\PhD\research\research-workspace\interactive-auto-mapping-tool\test-systems\ProM\sources\org\processmining\contexts\uitopia\hub\overlay\ProgressOverlayDialog.java", "Java", 136, 3, 34, 173
"c:\Users\zipasink\OneDrive\PhD\research\research-workspace\interactive-auto-mapping-tool\test-systems\ProM\sources\org\processmining\contexts\uitopia\model\AbstractAuthored.java", "Java", 26, 5, 10, 41
"c:\Users\zipasink\OneDrive\PhD\research\research-workspace\interactive-auto-mapping-tool\test-systems\ProM\sources\org\processmining\contexts\uitopia\model\ProMAction.java", "Java", 225, 27, 57, 309
"c:\Users\zipasink\OneDrive\PhD\research\research-workspace\interactive-auto-mapping-tool\test-systems\ProM\sources\org\processmining\contexts\uitopia\model\ProMCResource.java", "Java", 51, 6, 10, 67
"c:\Users\zipasink\OneDrive\PhD\research\research-workspace\interactive-auto-mapping-tool\test-systems\ProM\sources\org\processmining\contexts\uitopia\model\ProMCategory.java", "Java", 18, 0, 8, 26
"c:\Users\zipasink\OneDrive\PhD\research\research-workspace\interactive-auto-mapping-tool\test-systems\ProM\sources\org\processmining\contexts\uitopia\model\ProMPOResource.java", "Java", 48, 7, 10, 65
"c:\Users\zipasink\OneDrive\PhD\research\research-workspace\interactive-auto-mapping-tool\test-systems\ProM\sources\org\processmining\contexts\uitopia\model\ProMParameter.java", "Java", 33, 0, 11, 44
"c:\Users\zipasink\OneDrive\PhD\research\research-workspace\interactive-auto-mapping-tool\test-systems\ProM\sources\org\processmining\contexts\uitopia\model\ProMResource.java", "Java", 116, 0, 30, 146
"c:\Users\zipasink\OneDrive\PhD\research\research-workspace\interactive-auto-mapping-tool\test-systems\ProM\sources\org\processmining\contexts\uitopia\model\ProMResourceType.java", "Java", 108, 8, 29, 145
"c:\Users\zipasink\OneDrive\PhD\research\research-workspace\interactive-auto-mapping-tool\test-systems\ProM\sources\org\processmining\contexts\uitopia\model\ProMResourceTypeInformation.java", "Java", 65, 0, 19, 84
"c:\Users\zipasink\OneDrive\PhD\research\research-workspace\interactive-auto-mapping-tool\test-systems\ProM\sources\org\processmining\contexts\uitopia\model\ProMTask.java", "Java", 216, 35, 42, 293
"c:\Users\zipasink\OneDrive\PhD\research\research-workspace\interactive-auto-mapping-tool\test-systems\ProM\sources\org\processmining\contexts\uitopia\model\ProMView.java", "Java", 286, 11, 57, 354
"c:\Users\zipasink\OneDrive\PhD\research\research-workspace\interactive-auto-mapping-tool\test-systems\ProM\sources\org\processmining\contexts\uitopia\model\ProMViewType.java", "Java", 65, 0, 13, 78
"c:\Users\zipasink\OneDrive\PhD\research\research-workspace\interactive-auto-mapping-tool\test-systems\ProM\sources\org\processmining\contexts\uitopia\packagemanager\PMController.java", "Java", 197, 7, 30, 234
"c:\Users\zipasink\OneDrive\PhD\research\research-workspace\interactive-auto-mapping-tool\test-systems\ProM\sources\org\processmining\contexts\uitopia\packagemanager\PMFrame.java", "Java", 94, 4, 20, 118
"c:\Users\zipasink\OneDrive\PhD\research\research-workspace\interactive-auto-mapping-tool\test-systems\ProM\sources\org\processmining\contexts\uitopia\packagemanager\PMIconCache.java", "Java", 62, 21, 11, 94
"c:\Users\zipasink\OneDrive\PhD\research\research-workspace\interactive-auto-mapping-tool\test-systems\ProM\sources\org\processmining\contexts\uitopia\packagemanager\PMListener.java", "Java", 73, 0, 18, 91
"c:\Users\zipasink\OneDrive\PhD\research\research-workspace\interactive-auto-mapping-tool\test-systems\ProM\sources\org\processmining\contexts\uitopia\packagemanager\PMMainView.java", "Java", 107, 9, 29, 145
"c:\Users\zipasink\OneDrive\PhD\research\research-workspace\interactive-auto-mapping-tool\test-systems\ProM\sources\org\processmining\contexts\uitopia\packagemanager\PMMemoryView.java", "Java", 243, 113, 39, 395
"c:\Users\zipasink\OneDrive\PhD\research\research-workspace\interactive-auto-mapping-tool\test-systems\ProM\sources\org\processmining\contexts\uitopia\packagemanager\PMOverlay.java", "Java", 126, 22, 33, 181
"c:\Users\zipasink\OneDrive\PhD\research\research-workspace\interactive-auto-mapping-tool\test-systems\ProM\sources\org\processmining\contexts\uitopia\packagemanager\PMPackage.java", "Java", 59, 15, 21, 95
"c:\Users\zipasink\OneDrive\PhD\research\research-workspace\interactive-auto-mapping-tool\test-systems\ProM\sources\org\processmining\contexts\uitopia\packagemanager\PMPackageListBrowser.java", "Java", 289, 10, 29, 328
"c:\Users\zipasink\OneDrive\PhD\research\research-workspace\interactive-auto-mapping-tool\test-systems\ProM\sources\org\processmining\contexts\uitopia\packagemanager\PMPackageListCellRenderer.java", "Java", 134, 19, 15, 168
"c:\Users\zipasink\OneDrive\PhD\research\research-workspace\interactive-auto-mapping-tool\test-systems\ProM\sources\org\processmining\contexts\uitopia\packagemanager\PMPackageListModel.java", "Java", 61, 13, 15, 89
"c:\Users\zipasink\OneDrive\PhD\research\research-workspace\interactive-auto-mapping-tool\test-systems\ProM\sources\org\processmining\contexts\uitopia\packagemanager\PMPackageView.java", "Java", 347, 48, 24, 419
"c:\Users\zipasink\OneDrive\PhD\research\research-workspace\interactive-auto-mapping-tool\test-systems\ProM\sources\org\processmining\contexts\uitopia\packagemanager\PMSearchView.java", "Java", 58, 4, 12, 74
"c:\Users\zipasink\OneDrive\PhD\research\research-workspace\interactive-auto-mapping-tool\test-systems\ProM\sources\org\processmining\contexts\uitopia\packagemanager\PMTooltips.java", "Java", 10, 0, 4, 14
"c:\Users\zipasink\OneDrive\PhD\research\research-workspace\interactive-auto-mapping-tool\test-systems\ProM\sources\org\processmining\contexts\uitopia\packagemanager\PMWorkspaceBrowser.java", "Java", 130, 15, 25, 170
"c:\Users\zipasink\OneDrive\PhD\research\research-workspace\interactive-auto-mapping-tool\test-systems\ProM\sources\org\processmining\contexts\uitopia\packagemanager\PMWorkspaceView.java", "Java", 47, 6, 17, 70
"c:\Users\zipasink\OneDrive\PhD\research\research-workspace\interactive-auto-mapping-tool\test-systems\ProM\sources\org\processmining\contexts\util\HtmlPanel.java", "Java", 59, 16, 14, 89
"c:\Users\zipasink\OneDrive\PhD\research\research-workspace\interactive-auto-mapping-tool\test-systems\ProM\sources\org\processmining\contexts\util\StringVisualizer.java", "Java", 30, 0, 9, 39
"c:\Users\zipasink\OneDrive\PhD\research\research-workspace\interactive-auto-mapping-tool\test-systems\ProM\sources\org\processmining\contexts\util\ToolTipComboBox.java", "Java", 46, 70, 11, 127
"c:\Users\zipasink\OneDrive\PhD\research\research-workspace\interactive-auto-mapping-tool\test-systems\ProM\sources\org\processmining\contexts\util\jgraph\PortLabelCell.java", "Java", 20, 3, 9, 32
"c:\Users\zipasink\OneDrive\PhD\research\research-workspace\interactive-auto-mapping-tool\test-systems\ProM\sources\org\processmining\contexts\util\jgraph\PortLabelVertexView.java", "Java", 263, 99, 41, 403
"c:\Users\zipasink\OneDrive\PhD\research\research-workspace\interactive-auto-mapping-tool\test-systems\ProM\sources\org\processmining\filtering\FilterTestPlugin.java", "Java", 1, 41, 1, 43
"c:\Users\zipasink\OneDrive\PhD\research\research-workspace\interactive-auto-mapping-tool\test-systems\ProM\sources\org\processmining\filtering\filter\factories\FilterFactory.java", "Java", 14, 0, 7, 21
"c:\Users\zipasink\OneDrive\PhD\research\research-workspace\interactive-auto-mapping-tool\test-systems\ProM\sources\org\processmining\filtering\filter\implementations\FilterStackImpl.java", "Java", 25, 8, 10, 43
"c:\Users\zipasink\OneDrive\PhD\research\research-workspace\interactive-auto-mapping-tool\test-systems\ProM\sources\org\processmining\filtering\filter\implementations\MirrorFilterImpl.java", "Java", 17, 9, 5, 31
"c:\Users\zipasink\OneDrive\PhD\research\research-workspace\interactive-auto-mapping-tool\test-systems\ProM\sources\org\processmining\filtering\filter\interfaces\Filter.java", "Java", 5, 19, 4, 28
"c:\Users\zipasink\OneDrive\PhD\research\research-workspace\interactive-auto-mapping-tool\test-systems\ProM\sources\org\processmining\filtering\filter\interfaces\FilterStack.java", "Java", 5, 9, 4, 18
"c:\Users\zipasink\OneDrive\PhD\research\research-workspace\interactive-auto-mapping-tool\test-systems\ProM\sources\org\processmining\filtering\xfilter\factories\XFilterFactory.java", "Java", 19, 12, 6, 37
"c:\Users\zipasink\OneDrive\PhD\research\research-workspace\interactive-auto-mapping-tool\test-systems\ProM\sources\org\processmining\filtering\xfilter\implementations\HideXEventXAttributableFilterImpl.java", "Java", 37, 0, 12, 49
"c:\Users\zipasink\OneDrive\PhD\research\research-workspace\interactive-auto-mapping-tool\test-systems\ProM\sources\org\processmining\filtering\xfilter\implementations\XAttributableContainsKeyWithValueXFilterImpl.java", "Java", 71, 15, 14, 100
"c:\Users\zipasink\OneDrive\PhD\research\research-workspace\interactive-auto-mapping-tool\test-systems\ProM\sources\org\processmining\filtering\xfilter\interfaces\XAttributableFilter.java", "Java", 4, 0, 3, 7
"c:\Users\zipasink\OneDrive\PhD\research\research-workspace\interactive-auto-mapping-tool\test-systems\ProM\sources\org\processmining\filtering\xfilter\interfaces\XFilter.java", "Java", 4, 0, 4, 8
"c:\Users\zipasink\OneDrive\PhD\research\research-workspace\interactive-auto-mapping-tool\test-systems\ProM\sources\org\processmining\filtering\xflog\implementations\ShuffleInsertionList.java", "Java", 68, 12, 12, 92
"c:\Users\zipasink\OneDrive\PhD\research\research-workspace\interactive-auto-mapping-tool\test-systems\ProM\sources\org\processmining\filtering\xflog\implementations\XFLogImpl.java", "Java", 138, 7, 34, 179
"c:\Users\zipasink\OneDrive\PhD\research\research-workspace\interactive-auto-mapping-tool\test-systems\ProM\sources\org\processmining\filtering\xflog\implementations\XFTraceImpl.java", "Java", 103, 8, 27, 138
"c:\Users\zipasink\OneDrive\PhD\research\research-workspace\interactive-auto-mapping-tool\test-systems\ProM\sources\org\processmining\filtering\xflog\interfaces\XFLog.java", "Java", 11, 35, 7, 53
"c:\Users\zipasink\OneDrive\PhD\research\research-workspace\interactive-auto-mapping-tool\test-systems\ProM\sources\org\processmining\filtering\xflog\interfaces\XFTrace.java", "Java", 11, 31, 7, 49
"c:\Users\zipasink\OneDrive\PhD\research\research-workspace\interactive-auto-mapping-tool\test-systems\ProM\sources\org\processmining\framework\ProMID.java", "Java", 8, 26, 8, 42
"c:\Users\zipasink\OneDrive\PhD\research\research-workspace\interactive-auto-mapping-tool\test-systems\ProM\sources\org\processmining\framework\abstractplugins\AbstractImportPlugin.java", "Java", 53, 66, 19, 138
"c:\Users\zipasink\OneDrive\PhD\research\research-workspace\interactive-auto-mapping-tool\test-systems\ProM\sources\org\processmining\framework\abstractplugins\ImportPlugin.java", "Java", 17, 14, 10, 41
"c:\Users\zipasink\OneDrive\PhD\research\research-workspace\interactive-auto-mapping-tool\test-systems\ProM\sources\org\processmining\framework\annotations\AuthoredType.java", "Java", 15, 26, 10, 51
"c:\Users\zipasink\OneDrive\PhD\research\research-workspace\interactive-auto-mapping-tool\test-systems\ProM\sources\org\processmining\framework\annotations\Icon.java", "Java", 10, 6, 4, 20
"c:\Users\zipasink\OneDrive\PhD\research\research-workspace\interactive-auto-mapping-tool\test-systems\ProM\sources\org\processmining\framework\annotations\TestMethod.java", "Java", 12, 18, 7, 37
"c:\Users\zipasink\OneDrive\PhD\research\research-workspace\interactive-auto-mapping-tool\test-systems\ProM\sources\org\processmining\framework\boot\AddJarsForPackageRunnable.java", "Java", 79, 15, 9, 103
"c:\Users\zipasink\OneDrive\PhD\research\research-workspace\interactive-auto-mapping-tool\test-systems\ProM\sources\org\processmining\framework\boot\Boot.java", "Java", 404, 102, 65, 571
"c:\Users\zipasink\OneDrive\PhD\research\research-workspace\interactive-auto-mapping-tool\test-systems\ProM\sources\org\processmining\framework\boot\PathHackerRunnable.java", "Java", 26, 11, 6, 43
"c:\Users\zipasink\OneDrive\PhD\research\research-workspace\interactive-auto-mapping-tool\test-systems\ProM\sources\org\processmining\framework\connections\Connection.java", "Java", 22, 105, 17, 144
"c:\Users\zipasink\OneDrive\PhD\research\research-workspace\interactive-auto-mapping-tool\test-systems\ProM\sources\org\processmining\framework\connections\ConnectionAnnotation.java", "Java", 11, 7, 4, 22
"c:\Users\zipasink\OneDrive\PhD\research\research-workspace\interactive-auto-mapping-tool\test-systems\ProM\sources\org\processmining\framework\connections\ConnectionCannotBeObtained.java", "Java", 36, 31, 10, 77
"c:\Users\zipasink\OneDrive\PhD\research\research-workspace\interactive-auto-mapping-tool\test-systems\ProM\sources\org\processmining\framework\connections\ConnectionID.java", "Java", 4, 6, 5, 15
"c:\Users\zipasink\OneDrive\PhD\research\research-workspace\interactive-auto-mapping-tool\test-systems\ProM\sources\org\processmining\framework\connections\ConnectionManager.java", "Java", 17, 103, 13, 133
"c:\Users\zipasink\OneDrive\PhD\research\research-workspace\interactive-auto-mapping-tool\test-systems\ProM\sources\org\processmining\framework\connections\DynamicConnection.java", "Java", 3, 12, 3, 18
"c:\Users\zipasink\OneDrive\PhD\research\research-workspace\interactive-auto-mapping-tool\test-systems\ProM\sources\org\processmining\framework\connections\annotations\ConnectionDoesntExistMessage.java", "Java", 10, 0, 4, 14
"c:\Users\zipasink\OneDrive\PhD\research\research-workspace\interactive-auto-mapping-tool\test-systems\ProM\sources\org\processmining\framework\connections\annotations\ConnectionObjectFactory.java", "Java", 9, 13, 4, 26
"c:\Users\zipasink\OneDrive\PhD\research\research-workspace\interactive-auto-mapping-tool\test-systems\ProM\sources\org\processmining\framework\connections\impl\AbstractConnection.java", "Java", 169, 32, 29, 230
"c:\Users\zipasink\OneDrive\PhD\research\research-workspace\interactive-auto-mapping-tool\test-systems\ProM\sources\org\processmining\framework\connections\impl\AbstractStrongReferencingConnection.java", "Java", 28, 5, 7, 40
"c:\Users\zipasink\OneDrive\PhD\research\research-workspace\interactive-auto-mapping-tool\test-systems\ProM\sources\org\processmining\framework\connections\impl\ConnectionIDImpl.java", "Java", 29, 0, 12, 41
"c:\Users\zipasink\OneDrive\PhD\research\research-workspace\interactive-auto-mapping-tool\test-systems\ProM\sources\org\processmining\framework\connections\impl\ConnectionManagerImpl.java", "Java", 134, 6, 22, 162
"c:\Users\zipasink\OneDrive\PhD\research\research-workspace\interactive-auto-mapping-tool\test-systems\ProM\sources\org\processmining\framework\packages\CommandLineInterface.java", "Java", 178, 1, 39, 218
"c:\Users\zipasink\OneDrive\PhD\research\research-workspace\interactive-auto-mapping-tool\test-systems\ProM\sources\org\processmining\framework\packages\PackageDescriptor.java", "Java", 191, 0, 40, 231
"c:\Users\zipasink\OneDrive\PhD\research\research-workspace\interactive-auto-mapping-tool\test-systems\ProM\sources\org\processmining\framework\packages\PackageManager.java", "Java", 764, 178, 149, 1091
"c:\Users\zipasink\OneDrive\PhD\research\research-workspace\interactive-auto-mapping-tool\test-systems\ProM\sources\org\processmining\framework\packages\PackageSet.java", "Java", 29, 3, 6, 38
"c:\Users\zipasink\OneDrive\PhD\research\research-workspace\interactive-auto-mapping-tool\test-systems\ProM\sources\org\processmining\framework\packages\PackageStateReport.java", "Java", 57, 0, 12, 69
"c:\Users\zipasink\OneDrive\PhD\research\research-workspace\interactive-auto-mapping-tool\test-systems\ProM\sources\org\processmining\framework\packages\PackageVersion.java", "Java", 60, 0, 15, 75
"c:\Users\zipasink\OneDrive\PhD\research\research-workspace\interactive-auto-mapping-tool\test-systems\ProM\sources\org\processmining\framework\packages\Repository.java", "Java", 23, 0, 9, 32
"c:\Users\zipasink\OneDrive\PhD\research\research-workspace\interactive-auto-mapping-tool\test-systems\ProM\sources\org\processmining\framework\packages\UnknownPackageException.java", "Java", 12, 3, 5, 20
"c:\Users\zipasink\OneDrive\PhD\research\research-workspace\interactive-auto-mapping-tool\test-systems\ProM\sources\org\processmining\framework\packages\UnknownPackageTypeException.java", "Java", 12, 0, 5, 17
"c:\Users\zipasink\OneDrive\PhD\research\research-workspace\interactive-auto-mapping-tool\test-systems\ProM\sources\org\processmining\framework\packages\events\PackageManagerListener.java", "Java", 52, 0, 19, 71
"c:\Users\zipasink\OneDrive\PhD\research\research-workspace\interactive-auto-mapping-tool\test-systems\ProM\sources\org\processmining\framework\packages\impl\CancelledException.java", "Java", 5, 3, 5, 13
"c:\Users\zipasink\OneDrive\PhD\research\research-workspace\interactive-auto-mapping-tool\test-systems\ProM\sources\org\processmining\framework\packages\impl\PackageConfigPerister.java", "Java", 298, 26, 33, 357
"c:\Users\zipasink\OneDrive\PhD\research\research-workspace\interactive-auto-mapping-tool\test-systems\ProM\sources\org\processmining\framework\plugin\GlobalContext.java", "Java", 12, 66, 12, 90
"c:\Users\zipasink\OneDrive\PhD\research\research-workspace\interactive-auto-mapping-tool\test-systems\ProM\sources\org\processmining\framework\plugin\InSufficientResultException.java", "Java", 7, 6, 5, 18
"c:\Users\zipasink\OneDrive\PhD\research\research-workspace\interactive-auto-mapping-tool\test-systems\ProM\sources\org\processmining\framework\plugin\IncorrectReturnTypeException.java", "Java", 8, 6, 4, 18
"c:\Users\zipasink\OneDrive\PhD\research\research-workspace\interactive-auto-mapping-tool\test-systems\ProM\sources\org\processmining\framework\plugin\ObjectConstructor.java", "Java", 12, 85, 7, 104
"c:\Users\zipasink\OneDrive\PhD\research\research-workspace\interactive-auto-mapping-tool\test-systems\ProM\sources\org\processmining\framework\plugin\PluginContext.java", "Java", 38, 141, 30, 209
"c:\Users\zipasink\OneDrive\PhD\research\research-workspace\interactive-auto-mapping-tool\test-systems\ProM\sources\org\processmining\framework\plugin\PluginContextID.java", "Java", 5, 18, 5, 28
"c:\Users\zipasink\OneDrive\PhD\research\research-workspace\interactive-auto-mapping-tool\test-systems\ProM\sources\org\processmining\framework\plugin\PluginDescriptor.java", "Java", 46, 281, 43, 370
"c:\Users\zipasink\OneDrive\PhD\research\research-workspace\interactive-auto-mapping-tool\test-systems\ProM\sources\org\processmining\framework\plugin\PluginDescriptorID.java", "Java", 5, 20, 5, 30
"c:\Users\zipasink\OneDrive\PhD\research\research-workspace\interactive-auto-mapping-tool\test-systems\ProM\sources\org\processmining\framework\plugin\PluginExecutionResult.java", "Java", 16, 83, 15, 114
"c:\Users\zipasink\OneDrive\PhD\research\research-workspace\interactive-auto-mapping-tool\test-systems\ProM\sources\org\processmining\framework\plugin\PluginManager.java", "Java", 44, 342, 27, 413
"c:\Users\zipasink\OneDrive\PhD\research\research-workspace\interactive-auto-mapping-tool\test-systems\ProM\sources\org\processmining\framework\plugin\PluginParameterBinding.java", "Java", 164, 161, 32, 357
"c:\Users\zipasink\OneDrive\PhD\research\research-workspace\interactive-auto-mapping-tool\test-systems\ProM\sources\org\processmining\framework\plugin\ProMCanceller.java", "Java", 9, 11, 6, 26
"c:\Users\zipasink\OneDrive\PhD\research\research-workspace\interactive-auto-mapping-tool\test-systems\ProM\sources\org\processmining\framework\plugin\ProMFuture.java", "Java", 79, 109, 24, 212
"c:\Users\zipasink\OneDrive\PhD\research\research-workspace\interactive-auto-mapping-tool\test-systems\ProM\sources\org\processmining\framework\plugin\Progress.java", "Java", 16, 6, 15, 37
"c:\Users\zipasink\OneDrive\PhD\research\research-workspace\interactive-auto-mapping-tool\test-systems\ProM\sources\org\processmining\framework\plugin\RecursiveCallException.java", "Java", 8, 0, 4, 12
"c:\Users\zipasink\OneDrive\PhD\research\research-workspace\interactive-auto-mapping-tool\test-systems\ProM\sources\org\processmining\framework\plugin\annotations\Bootable.java", "Java", 9, 0, 3, 12
"c:\Users\zipasink\OneDrive\PhD\research\research-workspace\interactive-auto-mapping-tool\test-systems\ProM\sources\org\processmining\framework\plugin\annotations\CLI.java", "Java", 10, 0, 3, 13
"c:\Users\zipasink\OneDrive\PhD\research\research-workspace\interactive-auto-mapping-tool\test-systems\ProM\sources\org\processmining\framework\plugin\annotations\KeepInProMCache.java", "Java", 11, 12, 5, 28
"c:\Users\zipasink\OneDrive\PhD\research\research-workspace\interactive-auto-mapping-tool\test-systems\ProM\sources\org\processmining\framework\plugin\annotations\Plugin.java", "Java", 23, 88, 15, 126
"c:\Users\zipasink\OneDrive\PhD\research\research-workspace\interactive-auto-mapping-tool\test-systems\ProM\sources\org\processmining\framework\plugin\annotations\PluginCategory.java", "Java", 40, 8, 8, 56
"c:\Users\zipasink\OneDrive\PhD\research\research-workspace\interactive-auto-mapping-tool\test-systems\ProM\sources\org\processmining\framework\plugin\annotations\PluginLevel.java", "Java", 30, 0, 7, 37
"c:\Users\zipasink\OneDrive\PhD\research\research-workspace\interactive-auto-mapping-tool\test-systems\ProM\sources\org\processmining\framework\plugin\annotations\PluginQuality.java", "Java", 30, 0, 6, 36
"c:\Users\zipasink\OneDrive\PhD\research\research-workspace\interactive-auto-mapping-tool\test-systems\ProM\sources\org\processmining\framework\plugin\annotations\PluginVariant.java", "Java", 12, 19, 7, 38
"c:\Users\zipasink\OneDrive\PhD\research\research-workspace\interactive-auto-mapping-tool\test-systems\ProM\sources\org\processmining\framework\plugin\events\ConnectionObjectListener.java", "Java", 25, 23, 11, 59
"c:\Users\zipasink\OneDrive\PhD\research\research-workspace\interactive-auto-mapping-tool\test-systems\ProM\sources\org\processmining\framework\plugin\events\FutureListener.java", "Java", 13, 0, 7, 20
"c:\Users\zipasink\OneDrive\PhD\research\research-workspace\interactive-auto-mapping-tool\test-systems\ProM\sources\org\processmining\framework\plugin\events\Logger.java", "Java", 38, 17, 15, 70
"c:\Users\zipasink\OneDrive\PhD\research\research-workspace\interactive-auto-mapping-tool\test-systems\ProM\sources\org\processmining\framework\plugin\events\NameChangeListener.java", "Java", 12, 0, 5, 17
"c:\Users\zipasink\OneDrive\PhD\research\research-workspace\interactive-auto-mapping-tool\test-systems\ProM\sources\org\processmining\framework\plugin\events\PluginLifeCycleEventListener.java", "Java", 61, 55, 21, 137
"c:\Users\zipasink\OneDrive\PhD\research\research-workspace\interactive-auto-mapping-tool\test-systems\ProM\sources\org\processmining\framework\plugin\events\ProMEventListenerList.java", "Java", 41, 0, 10, 51
"c:\Users\zipasink\OneDrive\PhD\research\research-workspace\interactive-auto-mapping-tool\test-systems\ProM\sources\org\processmining\framework\plugin\events\ProgressEventListener.java", "Java", 30, 0, 10, 40
"c:\Users\zipasink\OneDrive\PhD\research\research-workspace\interactive-auto-mapping-tool\test-systems\ProM\sources\org\processmining\framework\plugin\events\ProvidedObjectLifeCycleListener.java", "Java", 38, 0, 14, 52
"c:\Users\zipasink\OneDrive\PhD\research\research-workspace\interactive-auto-mapping-tool\test-systems\ProM\sources\org\processmining\framework\plugin\impl\AbstractGlobalContext.java", "Java", 57, 15, 22, 94
"c:\Users\zipasink\OneDrive\PhD\research\research-workspace\interactive-auto-mapping-tool\test-systems\ProM\sources\org\processmining\framework\plugin\impl\AbstractPluginContext.java", "Java", 309, 108, 62, 479
"c:\Users\zipasink\OneDrive\PhD\research\research-workspace\interactive-auto-mapping-tool\test-systems\ProM\sources\org\processmining\framework\plugin\impl\AbstractPluginDescriptor.java", "Java", 190, 33, 32, 255
"c:\Users\zipasink\OneDrive\PhD\research\research-workspace\interactive-auto-mapping-tool\test-systems\ProM\sources\org\processmining\framework\plugin\impl\DependsOnUnknownException.java", "Java", 7, 7, 5, 19
"c:\Users\zipasink\OneDrive\PhD\research\research-workspace\interactive-auto-mapping-tool\test-systems\ProM\sources\org\processmining\framework\plugin\impl\FieldNotSetException.java", "Java", 7, 0, 4, 11
"c:\Users\zipasink\OneDrive\PhD\research\research-workspace\interactive-auto-mapping-tool\test-systems\ProM\sources\org\processmining\framework\plugin\impl\FieldSetException.java", "Java", 7, 0, 4, 11
"c:\Users\zipasink\OneDrive\PhD\research\research-workspace\interactive-auto-mapping-tool\test-systems\ProM\sources\org\processmining\framework\plugin\impl\PluginCacheEntry.java", "Java", 226, 88, 59, 373
"c:\Users\zipasink\OneDrive\PhD\research\research-workspace\interactive-auto-mapping-tool\test-systems\ProM\sources\org\processmining\framework\plugin\impl\PluginContextIDImpl.java", "Java", 26, 3, 9, 38
"c:\Users\zipasink\OneDrive\PhD\research\research-workspace\interactive-auto-mapping-tool\test-systems\ProM\sources\org\processmining\framework\plugin\impl\PluginDescriptorIDImpl.java", "Java", 37, 6, 12, 55
"c:\Users\zipasink\OneDrive\PhD\research\research-workspace\interactive-auto-mapping-tool\test-systems\ProM\sources\org\processmining\framework\plugin\impl\PluginDescriptorImpl.java", "Java", 424, 77, 76, 577
"c:\Users\zipasink\OneDrive\PhD\research\research-workspace\interactive-auto-mapping-tool\test-systems\ProM\sources\org\processmining\framework\plugin\impl\PluginExecutionResultImpl.java", "Java", 119, 0, 25, 144
"c:\Users\zipasink\OneDrive\PhD\research\research-workspace\interactive-auto-mapping-tool\test-systems\ProM\sources\org\processmining\framework\plugin\impl\PluginManagerImpl.java", "Java", 620, 129, 90, 839
"c:\Users\zipasink\OneDrive\PhD\research\research-workspace\interactive-auto-mapping-tool\test-systems\ProM\sources\org\processmining\framework\plugin\impl\ProgressBarImpl.java", "Java", 91, 6, 21, 118
"c:\Users\zipasink\OneDrive\PhD\research\research-workspace\interactive-auto-mapping-tool\test-systems\ProM\sources\org\processmining\framework\providedobjects\ContextAwareObject.java", "Java", 7, 15, 4, 26
"c:\Users\zipasink\OneDrive\PhD\research\research-workspace\interactive-auto-mapping-tool\test-systems\ProM\sources\org\processmining\framework\providedobjects\ProvidedObject.java", "Java", 12, 73, 12, 97
"c:\Users\zipasink\OneDrive\PhD\research\research-workspace\interactive-auto-mapping-tool\test-systems\ProM\sources\org\processmining\framework\providedobjects\ProvidedObjectDeletedException.java", "Java", 7, 3, 5, 15
"c:\Users\zipasink\OneDrive\PhD\research\research-workspace\interactive-auto-mapping-tool\test-systems\ProM\sources\org\processmining\framework\providedobjects\ProvidedObjectID.java", "Java", 4, 0, 4, 8
"c:\Users\zipasink\OneDrive\PhD\research\research-workspace\interactive-auto-mapping-tool\test-systems\ProM\sources\org\processmining\framework\providedobjects\ProvidedObjectManager.java", "Java", 20, 66, 19, 105
"c:\Users\zipasink\OneDrive\PhD\research\research-workspace\interactive-auto-mapping-tool\test-systems\ProM\sources\org\processmining\framework\providedobjects\SubstitutionType.java", "Java", 10, 0, 3, 13
"c:\Users\zipasink\OneDrive\PhD\research\research-workspace\interactive-auto-mapping-tool\test-systems\ProM\sources\org\processmining\framework\providedobjects\impl\ProvidedObjectIDImpl.java", "Java", 29, 0, 11, 40
"c:\Users\zipasink\OneDrive\PhD\research\research-workspace\interactive-auto-mapping-tool\test-systems\ProM\sources\org\processmining\framework\providedobjects\impl\ProvidedObjectImpl.java", "Java", 150, 14, 25, 189
"c:\Users\zipasink\OneDrive\PhD\research\research-workspace\interactive-auto-mapping-tool\test-systems\ProM\sources\org\processmining\framework\providedobjects\impl\ProvidedObjectManagerImpl.java", "Java", 124, 5, 29, 158
"c:\Users\zipasink\OneDrive\PhD\research\research-workspace\interactive-auto-mapping-tool\test-systems\ProM\sources\org\processmining\framework\util\ArrayUtils.java", "Java", 29, 29, 10, 68
"c:\Users\zipasink\OneDrive\PhD\research\research-workspace\interactive-auto-mapping-tool\test-systems\ProM\sources\org\processmining\framework\util\AutoHelpCommandLineParser.java", "Java", 76, 0, 21, 97
"c:\Users\zipasink\OneDrive\PhD\research\research-workspace\interactive-auto-mapping-tool\test-systems\ProM\sources\org\processmining\framework\util\Cast.java", "Java", 9, 14, 5, 28
"c:\Users\zipasink\OneDrive\PhD\research\research-workspace\interactive-auto-mapping-tool\test-systems\ProM\sources\org\processmining\framework\util\Cleanable.java", "Java", 4, 0, 3, 7
"c:\Users\zipasink\OneDrive\PhD\research\research-workspace\interactive-auto-mapping-tool\test-systems\ProM\sources\org\processmining\framework\util\CommandLineArgumentList.java", "Java", 8, 0, 6, 14
"c:\Users\zipasink\OneDrive\PhD\research\research-workspace\interactive-auto-mapping-tool\test-systems\ProM\sources\org\processmining\framework\util\GoogleAnalyticsUtil.java", "Java", 23, 11, 6, 40
"c:\Users\zipasink\OneDrive\PhD\research\research-workspace\interactive-auto-mapping-tool\test-systems\ProM\sources\org\processmining\framework\util\HTMLToString.java", "Java", 26, 3, 12, 41
"c:\Users\zipasink\OneDrive\PhD\research\research-workspace\interactive-auto-mapping-tool\test-systems\ProM\sources\org\processmining\framework\util\IconLoader.java", "Java", 22, 1, 9, 32
"c:\Users\zipasink\OneDrive\PhD\research\research-workspace\interactive-auto-mapping-tool\test-systems\ProM\sources\org\processmining\framework\util\LevenshteinDistance.java", "Java", 82, 11, 31, 124
"c:\Users\zipasink\OneDrive\PhD\research\research-workspace\interactive-auto-mapping-tool\test-systems\ProM\sources\org\processmining\framework\util\OsUtil.java", "Java", 115, 57, 23, 195
"c:\Users\zipasink\OneDrive\PhD\research\research-workspace\interactive-auto-mapping-tool\test-systems\ProM\sources\org\processmining\framework\util\Pair.java", "Java", 36, 0, 11, 47
"c:\Users\zipasink\OneDrive\PhD\research\research-workspace\interactive-auto-mapping-tool\test-systems\ProM\sources\org\processmining\framework\util\PathHacker.java", "Java", 76, 44, 12, 132
"c:\Users\zipasink\OneDrive\PhD\research\research-workspace\interactive-auto-mapping-tool\test-systems\ProM\sources\org\processmining\framework\util\ProMClassLoader.java", "Java", 8, 8, 7, 23
"c:\Users\zipasink\OneDrive\PhD\research\research-workspace\interactive-auto-mapping-tool\test-systems\ProM\sources\org\processmining\framework\util\StringUtils.java", "Java", 22, 0, 7, 29
"c:\Users\zipasink\OneDrive\PhD\research\research-workspace\interactive-auto-mapping-tool\test-systems\ProM\sources\org\processmining\framework\util\WeakValueHashMap.java", "Java", 228, 193, 64, 485
"c:\Users\zipasink\OneDrive\PhD\research\research-workspace\interactive-auto-mapping-tool\test-systems\ProM\sources\org\processmining\framework\util\collection\AbstractMultiSet.java", "Java", 285, 136, 43, 464
"c:\Users\zipasink\OneDrive\PhD\research\research-workspace\interactive-auto-mapping-tool\test-systems\ProM\sources\org\processmining\framework\util\collection\AlphanumComparator.java", "Java", 61, 41, 11, 113
"c:\Users\zipasink\OneDrive\PhD\research\research-workspace\interactive-auto-mapping-tool\test-systems\ProM\sources\org\processmining\framework\util\collection\ComparablePair.java", "Java", 22, 0, 7, 29
"c:\Users\zipasink\OneDrive\PhD\research\research-workspace\interactive-auto-mapping-tool\test-systems\ProM\sources\org\processmining\framework\util\collection\HashMultiSet.java", "Java", 26, 20, 8, 54
"c:\Users\zipasink\OneDrive\PhD\research\research-workspace\interactive-auto-mapping-tool\test-systems\ProM\sources\org\processmining\framework\util\collection\LinkedHashMultiSet.java", "Java", 19, 20, 7, 46
"c:\Users\zipasink\OneDrive\PhD\research\research-workspace\interactive-auto-mapping-tool\test-systems\ProM\sources\org\processmining\framework\util\collection\MultiSet.java", "Java", 12, 46, 10, 68
"c:\Users\zipasink\OneDrive\PhD\research\research-workspace\interactive-auto-mapping-tool\test-systems\ProM\sources\org\processmining\framework\util\collection\SortedMultiSet.java", "Java", 7, 5, 6, 18
"c:\Users\zipasink\OneDrive\PhD\research\research-workspace\interactive-auto-mapping-tool\test-systems\ProM\sources\org\processmining\framework\util\collection\TreeMultiSet.java", "Java", 53, 71, 14, 138
"c:\Users\zipasink\OneDrive\PhD\research\research-workspace\interactive-auto-mapping-tool\test-systems\ProM\sources\org\processmining\framework\util\collection\WeakKeyValueMap.java", "Java", 78, 0, 22, 100
"c:\Users\zipasink\OneDrive\PhD\research\research-workspace\interactive-auto-mapping-tool\test-systems\ProM\sources\org\processmining\framework\util\progress\XMonitoredInputStream.java", "Java", 71, 121, 18, 210
"c:\Users\zipasink\OneDrive\PhD\research\research-workspace\interactive-auto-mapping-tool\test-systems\ProM\sources\org\processmining\framework\util\progress\XProgressBarListener.java", "Java", 22, 85, 9, 116
"c:\Users\zipasink\OneDrive\PhD\research\research-workspace\interactive-auto-mapping-tool\test-systems\ProM\sources\org\processmining\framework\util\progress\XProgressListener.java", "Java", 5, 59, 5, 69
"c:\Users\zipasink\OneDrive\PhD\research\research-workspace\interactive-auto-mapping-tool\test-systems\ProM\sources\org\processmining\framework\util\search\BreadthFirstExpandCollection.java", "Java", 7, 0, 5, 12
"c:\Users\zipasink\OneDrive\PhD\research\research-workspace\interactive-auto-mapping-tool\test-systems\ProM\sources\org\processmining\framework\util\search\DepthFirstExpandCollection.java", "Java", 15, 0, 8, 23
"c:\Users\zipasink\OneDrive\PhD\research\research-workspace\interactive-auto-mapping-tool\test-systems\ProM\sources\org\processmining\framework\util\search\ExpandCollection.java", "Java", 7, 32, 7, 46
"c:\Users\zipasink\OneDrive\PhD\research\research-workspace\interactive-auto-mapping-tool\test-systems\ProM\sources\org\processmining\framework\util\search\MultiThreadedSearcher.java", "Java", 149, 173, 38, 360
"c:\Users\zipasink\OneDrive\PhD\research\research-workspace\interactive-auto-mapping-tool\test-systems\ProM\sources\org\processmining\framework\util\search\NodeExpander.java", "Java", 7, 66, 7, 80
"c:\Users\zipasink\OneDrive\PhD\research\research-workspace\interactive-auto-mapping-tool\test-systems\ProM\sources\org\processmining\framework\util\socket\Service.java", "Java", 82, 73, 20, 175
"c:\Users\zipasink\OneDrive\PhD\research\research-workspace\interactive-auto-mapping-tool\test-systems\ProM\sources\org\processmining\framework\util\socket\ServiceEnvironment.java", "Java", 10, 43, 11, 64
"c:\Users\zipasink\OneDrive\PhD\research\research-workspace\interactive-auto-mapping-tool\test-systems\ProM\sources\org\processmining\framework\util\socket\ServiceHandler.java", "Java", 7, 21, 4, 32
"c:\Users\zipasink\OneDrive\PhD\research\research-workspace\interactive-auto-mapping-tool\test-systems\ProM\sources\org\processmining\framework\util\ui\ExpandButton.java", "Java", 64, 34, 17, 115
"c:\Users\zipasink\OneDrive\PhD\research\research-workspace\interactive-auto-mapping-tool\test-systems\ProM\sources\org\processmining\framework\util\ui\SlickerConsole.java", "Java", 200, 74, 34, 308
"c:\Users\zipasink\OneDrive\PhD\research\research-workspace\interactive-auto-mapping-tool\test-systems\ProM\sources\org\processmining\framework\util\ui\SlickerMessageBar.java", "Java", 219, 43, 24, 286
"c:\Users\zipasink\OneDrive\PhD\research\research-workspace\interactive-auto-mapping-tool\test-systems\ProM\sources\org\processmining\framework\util\ui\TypeToggleButton.java", "Java", 100, 37, 17, 154
"c:\Users\zipasink\OneDrive\PhD\research\research-workspace\interactive-auto-mapping-tool\test-systems\ProM\sources\org\processmining\framework\util\ui\scalableview\DashedBorder.java", "Java", 22, 3, 6, 31
"c:\Users\zipasink\OneDrive\PhD\research\research-workspace\interactive-auto-mapping-tool\test-systems\ProM\sources\org\processmining\framework\util\ui\scalableview\ScalableComponent.java", "Java", 12, 37, 10, 59
"c:\Users\zipasink\OneDrive\PhD\research\research-workspace\interactive-auto-mapping-tool\test-systems\ProM\sources\org\processmining\framework\util\ui\scalableview\ScalableViewPanel.java", "Java", 429, 153, 90, 672
"c:\Users\zipasink\OneDrive\PhD\research\research-workspace\interactive-auto-mapping-tool\test-systems\ProM\sources\org\processmining\framework\util\ui\scalableview\VerticalLabelUI.java", "Java", 73, 1, 22, 96
"c:\Users\zipasink\OneDrive\PhD\research\research-workspace\interactive-auto-mapping-tool\test-systems\ProM\sources\org\processmining\framework\util\ui\scalableview\interaction\CompoundViewInteractionPanel.java", "Java", 222, 7, 46, 275
"c:\Users\zipasink\OneDrive\PhD\research\research-workspace\interactive-auto-mapping-tool\test-systems\ProM\sources\org\processmining\framework\util\ui\scalableview\interaction\ExportInteractionPanel.java", "Java", 54, 4, 19, 77
"c:\Users\zipasink\OneDrive\PhD\research\research-workspace\interactive-auto-mapping-tool\test-systems\ProM\sources\org\processmining\framework\util\ui\scalableview\interaction\PIPInteractionPanel.java", "Java", 292, 8, 68, 368
"c:\Users\zipasink\OneDrive\PhD\research\research-workspace\interactive-auto-mapping-tool\test-systems\ProM\sources\org\processmining\framework\util\ui\scalableview\interaction\ViewInteractionPanel.java", "Java", 14, 63, 11, 88
"c:\Users\zipasink\OneDrive\PhD\research\research-workspace\interactive-auto-mapping-tool\test-systems\ProM\sources\org\processmining\framework\util\ui\scalableview\interaction\ZoomInteractionPanel.java", "Java", 150, 4, 51, 205
"c:\Users\zipasink\OneDrive\PhD\research\research-workspace\interactive-auto-mapping-tool\test-systems\ProM\sources\org\processmining\framework\util\ui\widgets\BorderPanel.java", "Java", 33, 13, 8, 54
"c:\Users\zipasink\OneDrive\PhD\research\research-workspace\interactive-auto-mapping-tool\test-systems\ProM\sources\org\processmining\framework\util\ui\widgets\ColorScheme.java", "Java", 55, 8, 17, 80
"c:\Users\zipasink\OneDrive\PhD\research\research-workspace\interactive-auto-mapping-tool\test-systems\ProM\sources\org\processmining\framework\util\ui\widgets\ColorSchemeLegend.java", "Java", 85, 6, 21, 112
"c:\Users\zipasink\OneDrive\PhD\research\research-workspace\interactive-auto-mapping-tool\test-systems\ProM\sources\org\processmining\framework\util\ui\widgets\HeaderRenderer.java", "Java", 42, 25, 12, 79
"c:\Users\zipasink\OneDrive\PhD\research\research-workspace\interactive-auto-mapping-tool\test-systems\ProM\sources\org\processmining\framework\util\ui\widgets\Inspector.java", "Java", 261, 37, 35, 333
"c:\Users\zipasink\OneDrive\PhD\research\research-workspace\interactive-auto-mapping-tool\test-systems\ProM\sources\org\processmining\framework\util\ui\widgets\InspectorPanel.java", "Java", 141, 37, 25, 203
"c:\Users\zipasink\OneDrive\PhD\research\research-workspace\interactive-auto-mapping-tool\test-systems\ProM\sources\org\processmining\framework\util\ui\widgets\LeftAlignedHeader.java", "Java", 20, 12, 6, 38
"c:\Users\zipasink\OneDrive\PhD\research\research-workspace\interactive-auto-mapping-tool\test-systems\ProM\sources\org\processmining\framework\util\ui\widgets\ProMAutoCompletingTextField.java", "Java", 130, 36, 31, 197
"c:\Users\zipasink\OneDrive\PhD\research\research-workspace\interactive-auto-mapping-tool\test-systems\ProM\sources\org\processmining\framework\util\ui\widgets\ProMCheckBoxWithComboBox.java", "Java", 42, 47, 18, 107
"c:\Users\zipasink\OneDrive\PhD\research\research-workspace\interactive-auto-mapping-tool\test-systems\ProM\sources\org\processmining\framework\util\ui\widgets\ProMCheckBoxWithPanel.java", "Java", 54, 27, 21, 102
"c:\Users\zipasink\OneDrive\PhD\research\research-workspace\interactive-auto-mapping-tool\test-systems\ProM\sources\org\processmining\framework\util\ui\widgets\ProMCheckBoxWithTextField.java", "Java", 27, 28, 13, 68
"c:\Users\zipasink\OneDrive\PhD\research\research-workspace\interactive-auto-mapping-tool\test-systems\ProM\sources\org\processmining\framework\util\ui\widgets\ProMCheckComboBox.java", "Java", 50, 23, 12, 85
"c:\Users\zipasink\OneDrive\PhD\research\research-workspace\interactive-auto-mapping-tool\test-systems\ProM\sources\org\processmining\framework\util\ui\widgets\ProMComboBox.java", "Java", 77, 21, 16, 114
"c:\Users\zipasink\OneDrive\PhD\research\research-workspace\interactive-auto-mapping-tool\test-systems\ProM\sources\org\processmining\framework\util\ui\widgets\ProMComboBoxPopup.java", "Java", 42, 15, 11, 68
"c:\Users\zipasink\OneDrive\PhD\research\research-workspace\interactive-auto-mapping-tool\test-systems\ProM\sources\org\processmining\framework\util\ui\widgets\ProMComboBoxTableCellEditor.java", "Java", 39, 21, 9, 69
"c:\Users\zipasink\OneDrive\PhD\research\research-workspace\interactive-auto-mapping-tool\test-systems\ProM\sources\org\processmining\framework\util\ui\widgets\ProMComboBoxUI.java", "Java", 72, 18, 14, 104
"c:\Users\zipasink\OneDrive\PhD\research\research-workspace\interactive-auto-mapping-tool\test-systems\ProM\sources\org\processmining\framework\util\ui\widgets\ProMComboBoxWithTextField.java", "Java", 55, 45, 23, 123
"c:\Users\zipasink\OneDrive\PhD\research\research-workspace\interactive-auto-mapping-tool\test-systems\ProM\sources\org\processmining\framework\util\ui\widgets\ProMComboCheckBox.java", "Java", 55, 4, 12, 71
"c:\Users\zipasink\OneDrive\PhD\research\research-workspace\interactive-auto-mapping-tool\test-systems\ProM\sources\org\processmining\framework\util\ui\widgets\ProMHeaderPanel.java", "Java", 20, 12, 8, 40
"c:\Users\zipasink\OneDrive\PhD\research\research-workspace\interactive-auto-mapping-tool\test-systems\ProM\sources\org\processmining\framework\util\ui\widgets\ProMList.java", "Java", 107, 48, 24, 179
"c:\Users\zipasink\OneDrive\PhD\research\research-workspace\interactive-auto-mapping-tool\test-systems\ProM\sources\org\processmining\framework\util\ui\widgets\ProMListSortableWithComboBox.java", "Java", 205, 8, 45, 258
"c:\Users\zipasink\OneDrive\PhD\research\research-workspace\interactive-auto-mapping-tool\test-systems\ProM\sources\org\processmining\framework\util\ui\widgets\ProMPasswordField.java", "Java", 79, 49, 19, 147
"c:\Users\zipasink\OneDrive\PhD\research\research-workspace\interactive-auto-mapping-tool\test-systems\ProM\sources\org\processmining\framework\util\ui\widgets\ProMPropertiesExpertModePanel.java", "Java", 82, 13, 24, 119
"c:\Users\zipasink\OneDrive\PhD\research\research-workspace\interactive-auto-mapping-tool\test-systems\ProM\sources\org\processmining\framework\util\ui\widgets\ProMPropertiesPanel.java", "Java", 173, 62, 31, 266
"c:\Users\zipasink\OneDrive\PhD\research\research-workspace\interactive-auto-mapping-tool\test-systems\ProM\sources\org\processmining\framework\util\ui\widgets\ProMScrollContainer.java", "Java", 74, 43, 34, 151
"c:\Users\zipasink\OneDrive\PhD\research\research-workspace\interactive-auto-mapping-tool\test-systems\ProM\sources\org\processmining\framework\util\ui\widgets\ProMScrollContainerChild.java", "Java", 125, 55, 53, 233
"c:\Users\zipasink\OneDrive\PhD\research\research-workspace\interactive-auto-mapping-tool\test-systems\ProM\sources\org\processmining\framework\util\ui\widgets\ProMScrollPane.java", "Java", 29, 10, 8, 47
"c:\Users\zipasink\OneDrive\PhD\research\research-workspace\interactive-auto-mapping-tool\test-systems\ProM\sources\org\processmining\framework\util\ui\widgets\ProMScrollablePanel.java", "Java", 31, 24, 10, 65
"c:\Users\zipasink\OneDrive\PhD\research\research-workspace\interactive-auto-mapping-tool\test-systems\ProM\sources\org\processmining\framework\util\ui\widgets\ProMSplitPane.java", "Java", 226, 69, 43, 338
"c:\Users\zipasink\OneDrive\PhD\research\research-workspace\interactive-auto-mapping-tool\test-systems\ProM\sources\org\processmining\framework\util\ui\widgets\ProMTable.java", "Java", 146, 103, 41, 290
"c:\Users\zipasink\OneDrive\PhD\research\research-workspace\interactive-auto-mapping-tool\test-systems\ProM\sources\org\processmining\framework\util\ui\widgets\ProMTableWithoutPanel.java", "Java", 73, 6, 18, 97
"c:\Users\zipasink\OneDrive\PhD\research\research-workspace\interactive-auto-mapping-tool\test-systems\ProM\sources\org\processmining\framework\util\ui\widgets\ProMTextArea.java", "Java", 76, 51, 23, 150
"c:\Users\zipasink\OneDrive\PhD\research\research-workspace\interactive-auto-mapping-tool\test-systems\ProM\sources\org\processmining\framework\util\ui\widgets\ProMTextField.java", "Java", 132, 61, 32, 225
"c:\Users\zipasink\OneDrive\PhD\research\research-workspace\interactive-auto-mapping-tool\test-systems\ProM\sources\org\processmining\framework\util\ui\widgets\ProMTitledScrollContainerChild.java", "Java", 23, 19, 14, 56
"c:\Users\zipasink\OneDrive\PhD\research\research-workspace\interactive-auto-mapping-tool\test-systems\ProM\sources\org\processmining\framework\util\ui\widgets\WidgetColors.java", "Java", 13, 33, 4, 50
"c:\Users\zipasink\OneDrive\PhD\research\research-workspace\interactive-auto-mapping-tool\test-systems\ProM\sources\org\processmining\framework\util\ui\widgets\WidgetImages.java", "Java", 11, 15, 5, 31
"c:\Users\zipasink\OneDrive\PhD\research\research-workspace\interactive-auto-mapping-tool\test-systems\ProM\sources\org\processmining\framework\util\ui\widgets\helper\ChoiceQueryPanel.java", "Java", 32, 0, 11, 43
"c:\Users\zipasink\OneDrive\PhD\research\research-workspace\interactive-auto-mapping-tool\test-systems\ProM\sources\org\processmining\framework\util\ui\widgets\helper\FixedMappingQueryPanel.java", "Java", 94, 0, 27, 121
"c:\Users\zipasink\OneDrive\PhD\research\research-workspace\interactive-auto-mapping-tool\test-systems\ProM\sources\org\processmining\framework\util\ui\widgets\helper\FreeMappingQueryPanel.java", "Java", 89, 0, 28, 117
"c:\Users\zipasink\OneDrive\PhD\research\research-workspace\interactive-auto-mapping-tool\test-systems\ProM\sources\org\processmining\framework\util\ui\widgets\helper\MultilineStringQueryPanel.java", "Java", 37, 0, 14, 51
"c:\Users\zipasink\OneDrive\PhD\research\research-workspace\interactive-auto-mapping-tool\test-systems\ProM\sources\org\processmining\framework\util\ui\widgets\helper\MultipleChoiceQueryPanel.java", "Java", 36, 0, 11, 47
"c:\Users\zipasink\OneDrive\PhD\research\research-workspace\interactive-auto-mapping-tool\test-systems\ProM\sources\org\processmining\framework\util\ui\widgets\helper\ProMUIHelper.java", "Java", 337, 309, 60, 706
"c:\Users\zipasink\OneDrive\PhD\research\research-workspace\interactive-auto-mapping-tool\test-systems\ProM\sources\org\processmining\framework\util\ui\widgets\helper\SliderQueryPanel.java", "Java", 36, 0, 13, 49
"c:\Users\zipasink\OneDrive\PhD\research\research-workspace\interactive-auto-mapping-tool\test-systems\ProM\sources\org\processmining\framework\util\ui\widgets\helper\StringQueryPanel.java", "Java", 44, 0, 13, 57
"c:\Users\zipasink\OneDrive\PhD\research\research-workspace\interactive-auto-mapping-tool\test-systems\ProM\sources\org\processmining\framework\util\ui\widgets\helper\UserCancelledException.java", "Java", 16, 7, 8, 31
"c:\Users\zipasink\OneDrive\PhD\research\research-workspace\interactive-auto-mapping-tool\test-systems\ProM\sources\org\processmining\framework\util\ui\widgets\logging\CreateLogPlugin.java", "Java", 29, 8, 5, 42
"c:\Users\zipasink\OneDrive\PhD\research\research-workspace\interactive-auto-mapping-tool\test-systems\ProM\sources\org\processmining\framework\util\ui\widgets\logging\LogViewer.java", "Java", 185, 13, 27, 225
"c:\Users\zipasink\OneDrive\PhD\research\research-workspace\interactive-auto-mapping-tool\test-systems\ProM\sources\org\processmining\framework\util\ui\widgets\logging\Loggable.java", "Java", 5, 7, 3, 15
"c:\Users\zipasink\OneDrive\PhD\research\research-workspace\interactive-auto-mapping-tool\test-systems\ProM\sources\org\processmining\framework\util\ui\widgets\logging\ProMLoggable.java", "Java", 12, 10, 4, 26
"c:\Users\zipasink\OneDrive\PhD\research\research-workspace\interactive-auto-mapping-tool\test-systems\ProM\sources\org\processmining\framework\util\ui\widgets\traceview\ProMTraceList.java", "Java", 730, 340, 189, 1259
"c:\Users\zipasink\OneDrive\PhD\research\research-workspace\interactive-auto-mapping-tool\test-systems\ProM\sources\org\processmining\framework\util\ui\widgets\traceview\ProMTraceView.java", "Java", 877, 194, 227, 1298
"c:\Users\zipasink\OneDrive\PhD\research\research-workspace\interactive-auto-mapping-tool\test-systems\ProM\sources\org\processmining\framework\util\ui\widgets\traceview\SaveAsActionListener.java", "Java", 99, 0, 18, 117
"c:\Users\zipasink\OneDrive\PhD\research\research-workspace\interactive-auto-mapping-tool\test-systems\ProM\sources\org\processmining\framework\util\ui\widgets\traceview\masterdetail\DetailView.java", "Java", 9, 0, 9, 18
"c:\Users\zipasink\OneDrive\PhD\research\research-workspace\interactive-auto-mapping-tool\test-systems\ProM\sources\org\processmining\framework\util\ui\widgets\traceview\masterdetail\MasterView.java", "Java", 9, 0, 9, 18
"c:\Users\zipasink\OneDrive\PhD\research\research-workspace\interactive-auto-mapping-tool\test-systems\ProM\sources\org\processmining\framework\util\ui\widgets\traceview\masterdetail\ProMTraceListMasterDetail.java", "Java", 114, 0, 28, 142
"c:\Users\zipasink\OneDrive\PhD\research\research-workspace\interactive-auto-mapping-tool\test-systems\ProM\sources\org\processmining\framework\util\ui\widgets\traceview\masterdetail\TransparentSplitPane.java", "Java", 239, 61, 48, 348
"c:\Users\zipasink\OneDrive\PhD\research\research-workspace\interactive-auto-mapping-tool\test-systems\ProM\sources\org\processmining\framework\util\ui\widgets\traceview\model\FilteredListModel.java", "Java", 7, 0, 7, 14
"c:\Users\zipasink\OneDrive\PhD\research\research-workspace\interactive-auto-mapping-tool\test-systems\ProM\sources\org\processmining\framework\util\ui\widgets\traceview\model\FilteredListModelImpl.java", "Java", 71, 8, 15, 94
"c:\Users\zipasink\OneDrive\PhD\research\research-workspace\interactive-auto-mapping-tool\test-systems\ProM\sources\org\processmining\framework\util\ui\widgets\traceview\model\MutableListModel.java", "Java", 7, 0, 7, 14
"c:\Users\zipasink\OneDrive\PhD\research\research-workspace\interactive-auto-mapping-tool\test-systems\ProM\sources\org\processmining\framework\util\ui\widgets\traceview\model\SortableListModel.java", "Java", 5, 0, 5, 10
"c:\Users\zipasink\OneDrive\PhD\research\research-workspace\interactive-auto-mapping-tool\test-systems\ProM\sources\org\processmining\framework\util\ui\widgets\traceview\model\SortableListModelImpl.java", "Java", 58, 16, 14, 88
"c:\Users\zipasink\OneDrive\PhD\research\research-workspace\interactive-auto-mapping-tool\test-systems\ProM\sources\org\processmining\framework\util\ui\wizard\InformationStep.java", "Java", 20, 19, 9, 48
"c:\Users\zipasink\OneDrive\PhD\research\research-workspace\interactive-auto-mapping-tool\test-systems\ProM\sources\org\processmining\framework\util\ui\wizard\ListWizard.java", "Java", 65, 34, 24, 123
"c:\Users\zipasink\OneDrive\PhD\research\research-workspace\interactive-auto-mapping-tool\test-systems\ProM\sources\org\processmining\framework\util\ui\wizard\MapWizard.java", "Java", 71, 61, 23, 155
"c:\Users\zipasink\OneDrive\PhD\research\research-workspace\interactive-auto-mapping-tool\test-systems\ProM\sources\org\processmining\framework\util\ui\wizard\ProMWizard.java", "Java", 9, 35, 9, 53
"c:\Users\zipasink\OneDrive\PhD\research\research-workspace\interactive-auto-mapping-tool\test-systems\ProM\sources\org\processmining\framework\util\ui\wizard\ProMWizardDisplay.java", "Java", 56, 14, 18, 88
"c:\Users\zipasink\OneDrive\PhD\research\research-workspace\interactive-auto-mapping-tool\test-systems\ProM\sources\org\processmining\framework\util\ui\wizard\ProMWizardStep.java", "Java", 8, 22, 7, 37
"c:\Users\zipasink\OneDrive\PhD\research\research-workspace\interactive-auto-mapping-tool\test-systems\ProM\sources\org\processmining\framework\util\ui\wizard\TextAreaStep.java", "Java", 38, 0, 15, 53
"c:\Users\zipasink\OneDrive\PhD\research\research-workspace\interactive-auto-mapping-tool\test-systems\ProM\sources\org\processmining\framework\util\ui\wizard\TextStep.java", "Java", 27, 17, 15, 59
"c:\Users\zipasink\OneDrive\PhD\research\research-workspace\interactive-auto-mapping-tool\test-systems\ProM\sources\org\processmining\help\Apache20LicenseHelp.java", "Java", 5, 0, 3, 8
"c:\Users\zipasink\OneDrive\PhD\research\research-workspace\interactive-auto-mapping-tool\test-systems\ProM\sources\org\processmining\log\FileFormat.java", "Java", 13, 3, 5, 21
"c:\Users\zipasink\OneDrive\PhD\research\research-workspace\interactive-auto-mapping-tool\test-systems\ProM\sources\org\processmining\log\LogFileFormat.java", "Java", 12, 5, 5, 22
"c:\Users\zipasink\OneDrive\PhD\research\research-workspace\interactive-auto-mapping-tool\test-systems\ProM\sources\org\processmining\log\algorithms\HighFrequencyFilterAlgorithm.java", "Java", 105, 36, 16, 157
"c:\Users\zipasink\OneDrive\PhD\research\research-workspace\interactive-auto-mapping-tool\test-systems\ProM\sources\org\processmining\log\algorithms\LogCentralityAlgorithm.java", "Java", 12, 0, 4, 16
"c:\Users\zipasink\OneDrive\PhD\research\research-workspace\interactive-auto-mapping-tool\test-systems\ProM\sources\org\processmining\log\algorithms\LogCentralityFilterAlgorithm.java", "Java", 11, 0, 4, 15
"c:\Users\zipasink\OneDrive\PhD\research\research-workspace\interactive-auto-mapping-tool\test-systems\ProM\sources\org\processmining\log\algorithms\LogCentralityVisualizerAlgorithm.java", "Java", 150, 1, 22, 173
"c:\Users\zipasink\OneDrive\PhD\research\research-workspace\interactive-auto-mapping-tool\test-systems\ProM\sources\org\processmining\log\algorithms\LogCheckerAlgorithm.java", "Java", 19, 0, 4, 23
"c:\Users\zipasink\OneDrive\PhD\research\research-workspace\interactive-auto-mapping-tool\test-systems\ProM\sources\org\processmining\log\algorithms\LogFilterAlgorithm.java", "Java", 7, 0, 5, 12
"c:\Users\zipasink\OneDrive\PhD\research\research-workspace\interactive-auto-mapping-tool\test-systems\ProM\sources\org\processmining\log\algorithms\LogFrequencyAlgorithm.java", "Java", 33, 0, 7, 40
"c:\Users\zipasink\OneDrive\PhD\research\research-workspace\interactive-auto-mapping-tool\test-systems\ProM\sources\org\processmining\log\algorithms\LogFrequencyArrayAlgorithm.java", "Java", 36, 0, 7, 43
"c:\Users\zipasink\OneDrive\PhD\research\research-workspace\interactive-auto-mapping-tool\test-systems\ProM\sources\org\processmining\log\algorithms\LowFrequencyFilterAlgorithm.java", "Java", 53, 16, 14, 83
"c:\Users\zipasink\OneDrive\PhD\research\research-workspace\interactive-auto-mapping-tool\test-systems\ProM\sources\org\processmining\log\algorithms\LowOccurrencesFilterAlgorithm.java", "Java", 40, 3, 11, 54
"c:\Users\zipasink\OneDrive\PhD\research\research-workspace\interactive-auto-mapping-tool\test-systems\ProM\sources\org\processmining\log\algorithms\MergeLogsAlgorithm.java", "Java", 288, 50, 21, 359
"c:\Users\zipasink\OneDrive\PhD\research\research-workspace\interactive-auto-mapping-tool\test-systems\ProM\sources\org\processmining\log\algorithms\SplitLogAlgorithm.java", "Java", 59, 71, 10, 140
"c:\Users\zipasink\OneDrive\PhD\research\research-workspace\interactive-auto-mapping-tool\test-systems\ProM\sources\org\processmining\log\connections\HighFrequencyFilterConnection.java", "Java", 19, 0, 7, 26
"c:\Users\zipasink\OneDrive\PhD\research\research-workspace\interactive-auto-mapping-tool\test-systems\ProM\sources\org\processmining\log\connections\LogCentralityConnection.java", "Java", 20, 0, 6, 26
"c:\Users\zipasink\OneDrive\PhD\research\research-workspace\interactive-auto-mapping-tool\test-systems\ProM\sources\org\processmining\log\connections\LogCentralityFilterConnection.java", "Java", 20, 0, 6, 26
"c:\Users\zipasink\OneDrive\PhD\research\research-workspace\interactive-auto-mapping-tool\test-systems\ProM\sources\org\processmining\log\connections\LogFrequencyConnection.java", "Java", 20, 0, 6, 26
"c:\Users\zipasink\OneDrive\PhD\research\research-workspace\interactive-auto-mapping-tool\test-systems\ProM\sources\org\processmining\log\connections\LowFrequencyFilterConnection.java", "Java", 19, 0, 7, 26
"c:\Users\zipasink\OneDrive\PhD\research\research-workspace\interactive-auto-mapping-tool\test-systems\ProM\sources\org\processmining\log\connections\LowOccurrencesFilterConnection.java", "Java", 19, 0, 7, 26
"c:\Users\zipasink\OneDrive\PhD\research\research-workspace\interactive-auto-mapping-tool\test-systems\ProM\sources\org\processmining\log\csv\AbstractCSVFile.java", "Java", 40, 15, 10, 65
"c:\Users\zipasink\OneDrive\PhD\research\research-workspace\interactive-auto-mapping-tool\test-systems\ProM\sources\org\processmining\log\csv\CSVFile.java", "Java", 14, 57, 10, 81
"c:\Users\zipasink\OneDrive\PhD\research\research-workspace\interactive-auto-mapping-tool\test-systems\ProM\sources\org\processmining\log\csv\CSVFileReferenceOpenCSVImpl.java", "Java", 27, 26, 11, 64
"c:\Users\zipasink\OneDrive\PhD\research\research-workspace\interactive-auto-mapping-tool\test-systems\ProM\sources\org\processmining\log\csv\CSVFileReferenceUnivocityImpl.java", "Java", 32, 20, 12, 64
"c:\Users\zipasink\OneDrive\PhD\research\research-workspace\interactive-auto-mapping-tool\test-systems\ProM\sources\org\processmining\log\csv\CSVOpenCSVImpl.java", "Java", 55, 13, 19, 87
"c:\Users\zipasink\OneDrive\PhD\research\research-workspace\interactive-auto-mapping-tool\test-systems\ProM\sources\org\processmining\log\csv\CSVUnivocityImpl.java", "Java", 62, 10, 17, 89
"c:\Users\zipasink\OneDrive\PhD\research\research-workspace\interactive-auto-mapping-tool\test-systems\ProM\sources\org\processmining\log\csv\ICSV.java", "Java", 9, 26, 7, 42
"c:\Users\zipasink\OneDrive\PhD\research\research-workspace\interactive-auto-mapping-tool\test-systems\ProM\sources\org\processmining\log\csv\ICSVReader.java", "Java", 6, 13, 6, 25
"c:\Users\zipasink\OneDrive\PhD\research\research-workspace\interactive-auto-mapping-tool\test-systems\ProM\sources\org\processmining\log\csv\ICSVWriter.java", "Java", 6, 0, 6, 12
"c:\Users\zipasink\OneDrive\PhD\research\research-workspace\interactive-auto-mapping-tool\test-systems\ProM\sources\org\processmining\log\csv\config\CSVConfig.java", "Java", 119, 14, 25, 158
"c:\Users\zipasink\OneDrive\PhD\research\research-workspace\interactive-auto-mapping-tool\test-systems\ProM\sources\org\processmining\log\csv\config\CSVEscapeCharacter.java", "Java", 16, 0, 8, 24
"c:\Users\zipasink\OneDrive\PhD\research\research-workspace\interactive-auto-mapping-tool\test-systems\ProM\sources\org\processmining\log\csv\config\CSVQuoteCharacter.java", "Java", 18, 0, 9, 27
"c:\Users\zipasink\OneDrive\PhD\research\research-workspace\interactive-auto-mapping-tool\test-systems\ProM\sources\org\processmining\log\csv\config\CSVSeperator.java", "Java", 19, 0, 7, 26
"c:\Users\zipasink\OneDrive\PhD\research\research-workspace\interactive-auto-mapping-tool\test-systems\ProM\sources\org\processmining\log\csv\plugin\CSVViewer.java", "Java", 18, 0, 6, 24
"c:\Users\zipasink\OneDrive\PhD\research\research-workspace\interactive-auto-mapping-tool\test-systems\ProM\sources\org\processmining\log\csv\plugin\CSVViewerPanel.java", "Java", 171, 8, 43, 222
"c:\Users\zipasink\OneDrive\PhD\research\research-workspace\interactive-auto-mapping-tool\test-systems\ProM\sources\org\processmining\log\csvexport\CSVExportPlugin.java", "Java", 21, 6, 6, 33
"c:\Users\zipasink\OneDrive\PhD\research\research-workspace\interactive-auto-mapping-tool\test-systems\ProM\sources\org\processmining\log\csvexport\ExportLogCsv.java", "Java", 83, 25, 10, 118
"c:\Users\zipasink\OneDrive\PhD\research\research-workspace\interactive-auto-mapping-tool\test-systems\ProM\sources\org\processmining\log\csvexport\XesCsvSerializer.java", "Java", 199, 58, 27, 284
"c:\Users\zipasink\OneDrive\PhD\research\research-workspace\interactive-auto-mapping-tool\test-systems\ProM\sources\org\processmining\log\csvimport\CSVConversion.java", "Java", 392, 104, 82, 578
"c:\Users\zipasink\OneDrive\PhD\research\research-workspace\interactive-auto-mapping-tool\test-systems\ProM\sources\org\processmining\log\csvimport\CSVConversionCLI.java", "Java", 113, 6, 31, 150
"c:\Users\zipasink\OneDrive\PhD\research\research-workspace\interactive-auto-mapping-tool\test-systems\ProM\sources\org\processmining\log\csvimport\CSVConversionPlugin.java", "Java", 173, 8, 30, 211
"c:\Users\zipasink\OneDrive\PhD\research\research-workspace\interactive-auto-mapping-tool\test-systems\ProM\sources\org\processmining\log\csvimport\CSVImportPlugin.java", "Java", 16, 9, 6, 31
"c:\Users\zipasink\OneDrive\PhD\research\research-workspace\interactive-auto-mapping-tool\test-systems\ProM\sources\org\processmining\log\csvimport\CSVImportPluginUnivocity.java", "Java", 20, 6, 6, 32
"c:\Users\zipasink\OneDrive\PhD\research\research-workspace\interactive-auto-mapping-tool\test-systems\ProM\sources\org\processmining\log\csvimport\CSVSorter.java", "Java", 225, 25, 39, 289
"c:\Users\zipasink\OneDrive\PhD\research\research-workspace\interactive-auto-mapping-tool\test-systems\ProM\sources\org\processmining\log\csvimport\StringBasedImportOrdering.java", "Java", 24, 4, 6, 34
"c:\Users\zipasink\OneDrive\PhD\research\research-workspace\interactive-auto-mapping-tool\test-systems\ProM\sources\org\processmining\log\csvimport\config\CSVConversionConfig.java", "Java", 662, 38, 120, 820
"c:\Users\zipasink\OneDrive\PhD\research\research-workspace\interactive-auto-mapping-tool\test-systems\ProM\sources\org\processmining\log\csvimport\exception\CSVConversionConfigException.java", "Java", 19, 4, 10, 33
"c:\Users\zipasink\OneDrive\PhD\research\research-workspace\interactive-auto-mapping-tool\test-systems\ProM\sources\org\processmining\log\csvimport\exception\CSVConversionException.java", "Java", 19, 4, 11, 34
"c:\Users\zipasink\OneDrive\PhD\research\research-workspace\interactive-auto-mapping-tool\test-systems\ProM\sources\org\processmining\log\csvimport\exception\CSVSortException.java", "Java", 18, 4, 9, 31
"c:\Users\zipasink\OneDrive\PhD\research\research-workspace\interactive-auto-mapping-tool\test-systems\ProM\sources\org\processmining\log\csvimport\handler\CSVConversionHandler.java", "Java", 21, 88, 20, 129
"c:\Users\zipasink\OneDrive\PhD\research\research-workspace\interactive-auto-mapping-tool\test-systems\ProM\sources\org\processmining\log\csvimport\handler\XESConversionHandlerImpl.java", "Java", 312, 19, 53, 384
"c:\Users\zipasink\OneDrive\PhD\research\research-workspace\interactive-auto-mapping-tool\test-systems\ProM\sources\org\processmining\log\csvimport\ui\CSVConfigurationPanel.java", "Java", 14, 0, 9, 23
"c:\Users\zipasink\OneDrive\PhD\research\research-workspace\interactive-auto-mapping-tool\test-systems\ProM\sources\org\processmining\log\csvimport\ui\ConversionConfigUI.java", "Java", 345, 24, 66, 435
"c:\Users\zipasink\OneDrive\PhD\research\research-workspace\interactive-auto-mapping-tool\test-systems\ProM\sources\org\processmining\log\csvimport\ui\ExpertConfigUI.java", "Java", 186, 6, 38, 230
"c:\Users\zipasink\OneDrive\PhD\research\research-workspace\interactive-auto-mapping-tool\test-systems\ProM\sources\org\processmining\log\csvimport\ui\ImportConfigUI.java", "Java", 169, 8, 43, 220
"c:\Users\zipasink\OneDrive\PhD\research\research-workspace\interactive-auto-mapping-tool\test-systems\ProM\sources\org\processmining\log\csvimport\ui\preview\CSVPreviewFrame.java", "Java", 334, 6, 65, 405
"c:\Users\zipasink\OneDrive\PhD\research\research-workspace\interactive-auto-mapping-tool\test-systems\ProM\sources\org\processmining\log\csvimport\ui\preview\CSVPreviewPanel.java", "Java", 99, 0, 30, 129
"c:\Users\zipasink\OneDrive\PhD\research\research-workspace\interactive-auto-mapping-tool\test-systems\ProM\sources\org\processmining\log\dialogs\ClassifierPanel.java", "Java", 56, 9, 14, 79
"c:\Users\zipasink\OneDrive\PhD\research\research-workspace\interactive-auto-mapping-tool\test-systems\ProM\sources\org\processmining\log\dialogs\HighFrequencyFilterDialog.java", "Java", 35, 3, 14, 52
"c:\Users\zipasink\OneDrive\PhD\research\research-workspace\interactive-auto-mapping-tool\test-systems\ProM\sources\org\processmining\log\dialogs\LogCentralityDialog.java", "Java", 45, 6, 9, 60
"c:\Users\zipasink\OneDrive\PhD\research\research-workspace\interactive-auto-mapping-tool\test-systems\ProM\sources\org\processmining\log\dialogs\LogCentralityFilterDialog.java", "Java", 56, 3, 17, 76
"c:\Users\zipasink\OneDrive\PhD\research\research-workspace\interactive-auto-mapping-tool\test-systems\ProM\sources\org\processmining\log\dialogs\LogFrequencyDialog.java", "Java", 14, 3, 8, 25
"c:\Users\zipasink\OneDrive\PhD\research\research-workspace\interactive-auto-mapping-tool\test-systems\ProM\sources\org\processmining\log\dialogs\LowFrequencyFilterDialog.java", "Java", 27, 3, 11, 41
"c:\Users\zipasink\OneDrive\PhD\research\research-workspace\interactive-auto-mapping-tool\test-systems\ProM\sources\org\processmining\log\dialogs\LowOccurrencesFilterDialog.java", "Java", 27, 3, 11, 41
"c:\Users\zipasink\OneDrive\PhD\research\research-workspace\interactive-auto-mapping-tool\test-systems\ProM\sources\org\processmining\log\dialogs\MergeLogsDialog.java", "Java", 225, 6, 48, 279
"c:\Users\zipasink\OneDrive\PhD\research\research-workspace\interactive-auto-mapping-tool\test-systems\ProM\sources\org\processmining\log\dialogs\MinerPanel.java", "Java", 51, 6, 13, 70
"c:\Users\zipasink\OneDrive\PhD\research\research-workspace\interactive-auto-mapping-tool\test-systems\ProM\sources\org\processmining\log\dialogs\SplitLogDialog.java", "Java", 57, 6, 8, 71
"c:\Users\zipasink\OneDrive\PhD\research\research-workspace\interactive-auto-mapping-tool\test-systems\ProM\sources\org\processmining\log\filters\AddIdentityFilter.java", "Java", 113, 6, 32, 151
"c:\Users\zipasink\OneDrive\PhD\research\research-workspace\interactive-auto-mapping-tool\test-systems\ProM\sources\org\processmining\log\filters\ExtensionFilter.java", "Java", 104, 10, 41, 155
"c:\Users\zipasink\OneDrive\PhD\research\research-workspace\interactive-auto-mapping-tool\test-systems\ProM\sources\org\processmining\log\filters\ui\AddIdentityFilterUI.java", "Java", 33, 0, 6, 39
"c:\Users\zipasink\OneDrive\PhD\research\research-workspace\interactive-auto-mapping-tool\test-systems\ProM\sources\org\processmining\log\filters\ui\ExtensionFilterUI.java", "Java", 63, 8, 24, 95
"c:\Users\zipasink\OneDrive\PhD\research\research-workspace\interactive-auto-mapping-tool\test-systems\ProM\sources\org\processmining\log\formats\StandardDateFormats.java", "Java", 166, 8, 20, 194
"c:\Users\zipasink\OneDrive\PhD\research\research-workspace\interactive-auto-mapping-tool\test-systems\ProM\sources\org\processmining\log\help\HighFrequencyFilterArrayHelp.java", "Java", 10, 0, 4, 14
"c:\Users\zipasink\OneDrive\PhD\research\research-workspace\interactive-auto-mapping-tool\test-systems\ProM\sources\org\processmining\log\help\HighFrequencyFilterHelp.java", "Java", 10, 0, 4, 14
"c:\Users\zipasink\OneDrive\PhD\research\research-workspace\interactive-auto-mapping-tool\test-systems\ProM\sources\org\processmining\log\help\LogCentralityFilterHelp.java", "Java", 6, 0, 4, 10
"c:\Users\zipasink\OneDrive\PhD\research\research-workspace\interactive-auto-mapping-tool\test-systems\ProM\sources\org\processmining\log\help\LogCentralityHelp.java", "Java", 5, 0, 4, 9
"c:\Users\zipasink\OneDrive\PhD\research\research-workspace\interactive-auto-mapping-tool\test-systems\ProM\sources\org\processmining\log\help\LogCheckerHelp.java", "Java", 5, 0, 3, 8
"c:\Users\zipasink\OneDrive\PhD\research\research-workspace\interactive-auto-mapping-tool\test-systems\ProM\sources\org\processmining\log\help\LogFrequencyArrayHelp.java", "Java", 6, 0, 4, 10
"c:\Users\zipasink\OneDrive\PhD\research\research-workspace\interactive-auto-mapping-tool\test-systems\ProM\sources\org\processmining\log\help\LogFrequencyHelp.java", "Java", 7, 0, 4, 11
"c:\Users\zipasink\OneDrive\PhD\research\research-workspace\interactive-auto-mapping-tool\test-systems\ProM\sources\org\processmining\log\help\LowFrequencyFilterArrayHelp.java", "Java", 6, 0, 4, 10
"c:\Users\zipasink\OneDrive\PhD\research\research-workspace\interactive-auto-mapping-tool\test-systems\ProM\sources\org\processmining\log\help\LowFrequencyFilterHelp.java", "Java", 6, 0, 4, 10
"c:\Users\zipasink\OneDrive\PhD\research\research-workspace\interactive-auto-mapping-tool\test-systems\ProM\sources\org\processmining\log\help\LowOccurrencesFilterArrayHelp.java", "Java", 6, 0, 4, 10
"c:\Users\zipasink\OneDrive\PhD\research\research-workspace\interactive-auto-mapping-tool\test-systems\ProM\sources\org\processmining\log\help\LowOccurrencesFilterHelp.java", "Java", 6, 0, 4, 10
"c:\Users\zipasink\OneDrive\PhD\research\research-workspace\interactive-auto-mapping-tool\test-systems\ProM\sources\org\processmining\log\help\MergeLogsHelp.java", "Java", 5, 0, 3, 8
"c:\Users\zipasink\OneDrive\PhD\research\research-workspace\interactive-auto-mapping-tool\test-systems\ProM\sources\org\processmining\log\help\SplitLogHelp.java", "Java", 9, 0, 3, 12
"c:\Users\zipasink\OneDrive\PhD\research\research-workspace\interactive-auto-mapping-tool\test-systems\ProM\sources\org\processmining\log\logchecks\LogCheck.java", "Java", 7, 0, 5, 12
"c:\Users\zipasink\OneDrive\PhD\research\research-workspace\interactive-auto-mapping-tool\test-systems\ProM\sources\org\processmining\log\logchecks\LogCheckType.java", "Java", 16, 0, 9, 25
"c:\Users\zipasink\OneDrive\PhD\research\research-workspace\interactive-auto-mapping-tool\test-systems\ProM\sources\org\processmining\log\logchecks\impl\LogCheckConsistentTypes.java", "Java", 155, 0, 17, 172
"c:\Users\zipasink\OneDrive\PhD\research\research-workspace\interactive-auto-mapping-tool\test-systems\ProM\sources\org\processmining\log\logchecks\impl\LogCheckEventClassifiersGlobal.java", "Java", 42, 0, 9, 51
"c:\Users\zipasink\OneDrive\PhD\research\research-workspace\interactive-auto-mapping-tool\test-systems\ProM\sources\org\processmining\log\logchecks\impl\LogCheckGlobalAttributes.java", "Java", 73, 0, 9, 82
"c:\Users\zipasink\OneDrive\PhD\research\research-workspace\interactive-auto-mapping-tool\test-systems\ProM\sources\org\processmining\log\models\EventLogArray.java", "Java", 22, 37, 12, 71
"c:\Users\zipasink\OneDrive\PhD\research\research-workspace\interactive-auto-mapping-tool\test-systems\ProM\sources\org\processmining\log\models\LogCentrality.java", "Java", 138, 0, 17, 155
"c:\Users\zipasink\OneDrive\PhD\research\research-workspace\interactive-auto-mapping-tool\test-systems\ProM\sources\org\processmining\log\models\LogCheckerReport.java", "Java", 14, 0, 8, 22
"c:\Users\zipasink\OneDrive\PhD\research\research-workspace\interactive-auto-mapping-tool\test-systems\ProM\sources\org\processmining\log\models\LogFrequency.java", "Java", 6, 0, 5, 11
"c:\Users\zipasink\OneDrive\PhD\research\research-workspace\interactive-auto-mapping-tool\test-systems\ProM\sources\org\processmining\log\models\LogFrequencyArray.java", "Java", 4, 0, 4, 8
"c:\Users\zipasink\OneDrive\PhD\research\research-workspace\interactive-auto-mapping-tool\test-systems\ProM\sources\org\processmining\log\models\XEventClassifierList.java", "Java", 5, 0, 5, 10
"c:\Users\zipasink\OneDrive\PhD\research\research-workspace\interactive-auto-mapping-tool\test-systems\ProM\sources\org\processmining\log\models\impl\EventLogArrayFactory.java", "Java", 7, 0, 5, 12
"c:\Users\zipasink\OneDrive\PhD\research\research-workspace\interactive-auto-mapping-tool\test-systems\ProM\sources\org\processmining\log\models\impl\EventLogArrayImpl.java", "Java", 62, 0, 15, 77
"c:\Users\zipasink\OneDrive\PhD\research\research-workspace\interactive-auto-mapping-tool\test-systems\ProM\sources\org\processmining\log\models\impl\LogFrequencyArrayImpl.java", "Java", 65, 1, 10, 76
"c:\Users\zipasink\OneDrive\PhD\research\research-workspace\interactive-auto-mapping-tool\test-systems\ProM\sources\org\processmining\log\models\impl\LogFrequencyFactory.java", "Java", 13, 0, 6, 19
"c:\Users\zipasink\OneDrive\PhD\research\research-workspace\interactive-auto-mapping-tool\test-systems\ProM\sources\org\processmining\log\models\impl\LogFrequencyImpl.java", "Java", 50, 0, 8, 58
"c:\Users\zipasink\OneDrive\PhD\research\research-workspace\interactive-auto-mapping-tool\test-systems\ProM\sources\org\processmining\log\models\impl\XEventClassifierListImpl.java", "Java", 7, 3, 6, 16
"c:\Users\zipasink\OneDrive\PhD\research\research-workspace\interactive-auto-mapping-tool\test-systems\ProM\sources\org\processmining\log\parameters\AbstractLogFilterParameters.java", "Java", 28, 0, 9, 37
"c:\Users\zipasink\OneDrive\PhD\research\research-workspace\interactive-auto-mapping-tool\test-systems\ProM\sources\org\processmining\log\parameters\ClassifierParameter.java", "Java", 6, 0, 4, 10
"c:\Users\zipasink\OneDrive\PhD\research\research-workspace\interactive-auto-mapping-tool\test-systems\ProM\sources\org\processmining\log\parameters\HighFrequencyFilterParameters.java", "Java", 38, 8, 12, 58
"c:\Users\zipasink\OneDrive\PhD\research\research-workspace\interactive-auto-mapping-tool\test-systems\ProM\sources\org\processmining\log\parameters\LogCentralityFilterParameters.java", "Java", 38, 0, 13, 51
"c:\Users\zipasink\OneDrive\PhD\research\research-workspace\interactive-auto-mapping-tool\test-systems\ProM\sources\org\processmining\log\parameters\LogCentralityParameters.java", "Java", 18, 0, 6, 24
"c:\Users\zipasink\OneDrive\PhD\research\research-workspace\interactive-auto-mapping-tool\test-systems\ProM\sources\org\processmining\log\parameters\LogCheckerParameters.java", "Java", 12, 0, 8, 20
"c:\Users\zipasink\OneDrive\PhD\research\research-workspace\interactive-auto-mapping-tool\test-systems\ProM\sources\org\processmining\log\parameters\LogFilterParameters.java", "Java", 4, 0, 6, 10
"c:\Users\zipasink\OneDrive\PhD\research\research-workspace\interactive-auto-mapping-tool\test-systems\ProM\sources\org\processmining\log\parameters\LogFrequencyParameters.java", "Java", 18, 0, 6, 24
"c:\Users\zipasink\OneDrive\PhD\research\research-workspace\interactive-auto-mapping-tool\test-systems\ProM\sources\org\processmining\log\parameters\LowFrequencyFilterParameters.java", "Java", 28, 3, 9, 40
"c:\Users\zipasink\OneDrive\PhD\research\research-workspace\interactive-auto-mapping-tool\test-systems\ProM\sources\org\processmining\log\parameters\LowOccurrencesFilterParameters.java", "Java", 28, 3, 9, 40
"c:\Users\zipasink\OneDrive\PhD\research\research-workspace\interactive-auto-mapping-tool\test-systems\ProM\sources\org\processmining\log\parameters\MergeLogsParameters.java", "Java", 94, 0, 28, 122
"c:\Users\zipasink\OneDrive\PhD\research\research-workspace\interactive-auto-mapping-tool\test-systems\ProM\sources\org\processmining\log\parameters\MinerParameter.java", "Java", 5, 0, 3, 8
"c:\Users\zipasink\OneDrive\PhD\research\research-workspace\interactive-auto-mapping-tool\test-systems\ProM\sources\org\processmining\log\parameters\SplitLogParameters.java", "Java", 27, 0, 7, 34
"c:\Users\zipasink\OneDrive\PhD\research\research-workspace\interactive-auto-mapping-tool\test-systems\ProM\sources\org\processmining\log\parameters\UpdateParameter.java", "Java", 4, 0, 3, 7
"c:\Users\zipasink\OneDrive\PhD\research\research-workspace\interactive-auto-mapping-tool\test-systems\ProM\sources\org\processmining\log\parsers\SaxHandlerGlobalEventAttributesParser.java", "Java", 37, 0, 11, 48
"c:\Users\zipasink\OneDrive\PhD\research\research-workspace\interactive-auto-mapping-tool\test-systems\ProM\sources\org\processmining\log\parsers\SaxHandlerXEventClassifierParser.java", "Java", 74, 26, 14, 114
"c:\Users\zipasink\OneDrive\PhD\research\research-workspace\interactive-auto-mapping-tool\test-systems\ProM\sources\org\processmining\log\plugins\ExportEventLogArrayAsCompressedMXMLPlugin.java", "Java", 18, 0, 6, 24
"c:\Users\zipasink\OneDrive\PhD\research\research-workspace\interactive-auto-mapping-tool\test-systems\ProM\sources\org\processmining\log\plugins\ExportEventLogArrayAsCompressedXESPlugin.java", "Java", 18, 0, 6, 24
"c:\Users\zipasink\OneDrive\PhD\research\research-workspace\interactive-auto-mapping-tool\test-systems\ProM\sources\org\processmining\log\plugins\ExportEventLogArrayAsMXMLPlugin.java", "Java", 18, 0, 5, 23
"c:\Users\zipasink\OneDrive\PhD\research\research-workspace\interactive-auto-mapping-tool\test-systems\ProM\sources\org\processmining\log\plugins\ExportEventLogArrayAsXESPlugin.java", "Java", 18, 0, 6, 24
"c:\Users\zipasink\OneDrive\PhD\research\research-workspace\interactive-auto-mapping-tool\test-systems\ProM\sources\org\processmining\log\plugins\HighFrequencyFilterArrayPlugin.java", "Java", 80, 9, 9, 98
"c:\Users\zipasink\OneDrive\PhD\research\research-workspace\interactive-auto-mapping-tool\test-systems\ProM\sources\org\processmining\log\plugins\HighFrequencyFilterPlugin.java", "Java", 74, 9, 11, 94
"c:\Users\zipasink\OneDrive\PhD\research\research-workspace\interactive-auto-mapping-tool\test-systems\ProM\sources\org\processmining\log\plugins\ImportEventLogArrayPlugin.java", "Java", 82, 3, 9, 94
"c:\Users\zipasink\OneDrive\PhD\research\research-workspace\interactive-auto-mapping-tool\test-systems\ProM\sources\org\processmining\log\plugins\ImportXEventClassifierListPlugin.java", "Java", 39, 0, 8, 47
"c:\Users\zipasink\OneDrive\PhD\research\research-workspace\interactive-auto-mapping-tool\test-systems\ProM\sources\org\processmining\log\plugins\LogCentralityFilterPlugin.java", "Java", 64, 0, 8, 72
"c:\Users\zipasink\OneDrive\PhD\research\research-workspace\interactive-auto-mapping-tool\test-systems\ProM\sources\org\processmining\log\plugins\LogCentralityPlugin.java", "Java", 75, 6, 10, 91
"c:\Users\zipasink\OneDrive\PhD\research\research-workspace\interactive-auto-mapping-tool\test-systems\ProM\sources\org\processmining\log\plugins\LogCentralityVisualizerPlugin.java", "Java", 25, 0, 7, 32
"c:\Users\zipasink\OneDrive\PhD\research\research-workspace\interactive-auto-mapping-tool\test-systems\ProM\sources\org\processmining\log\plugins\LogCheckerPlugin.java", "Java", 27, 0, 5, 32
"c:\Users\zipasink\OneDrive\PhD\research\research-workspace\interactive-auto-mapping-tool\test-systems\ProM\sources\org\processmining\log\plugins\LogFrequencyArrayPlugin.java", "Java", 49, 9, 9, 67
"c:\Users\zipasink\OneDrive\PhD\research\research-workspace\interactive-auto-mapping-tool\test-systems\ProM\sources\org\processmining\log\plugins\LogFrequencyPlugin.java", "Java", 76, 9, 11, 96
"c:\Users\zipasink\OneDrive\PhD\research\research-workspace\interactive-auto-mapping-tool\test-systems\ProM\sources\org\processmining\log\plugins\LowFrequencyFilterArrayPlugin.java", "Java", 78, 9, 9, 96
"c:\Users\zipasink\OneDrive\PhD\research\research-workspace\interactive-auto-mapping-tool\test-systems\ProM\sources\org\processmining\log\plugins\LowFrequencyFilterPlugin.java", "Java", 75, 9, 11, 95
"c:\Users\zipasink\OneDrive\PhD\research\research-workspace\interactive-auto-mapping-tool\test-systems\ProM\sources\org\processmining\log\plugins\LowOccurrencesFilterArrayPlugin.java", "Java", 77, 9, 10, 96
"c:\Users\zipasink\OneDrive\PhD\research\research-workspace\interactive-auto-mapping-tool\test-systems\ProM\sources\org\processmining\log\plugins\LowOccurrencesFilterPlugin.java", "Java", 75, 9, 12, 96
"c:\Users\zipasink\OneDrive\PhD\research\research-workspace\interactive-auto-mapping-tool\test-systems\ProM\sources\org\processmining\log\plugins\MergeLogsPlugin.java", "Java", 42, 0, 10, 52
"c:\Users\zipasink\OneDrive\PhD\research\research-workspace\interactive-auto-mapping-tool\test-systems\ProM\sources\org\processmining\log\plugins\SplitLogPlugin.java", "Java", 42, 0, 10, 52
"c:\Users\zipasink\OneDrive\PhD\research\research-workspace\interactive-auto-mapping-tool\test-systems\ProM\sources\org\processmining\log\repair\RepairAttributeDataType.java", "Java", 447, 36, 74, 557
"c:\Users\zipasink\OneDrive\PhD\research\research-workspace\interactive-auto-mapping-tool\test-systems\ProM\sources\org\processmining\log\repair\RepairGlobalAttributesPlugin.java", "Java", 241, 0, 48, 289
"c:\Users\zipasink\OneDrive\PhD\research\research-workspace\interactive-auto-mapping-tool\test-systems\ProM\sources\org\processmining\log\repair\UnexpectedDataTypeException.java", "Java", 15, 0, 8, 23
"c:\Users\zipasink\OneDrive\PhD\research\research-workspace\interactive-auto-mapping-tool\test-systems\ProM\sources\org\processmining\log\utils\MergeLogsUtils.java", "Java", 16, 0, 7, 23
"c:\Users\zipasink\OneDrive\PhD\research\research-workspace\interactive-auto-mapping-tool\test-systems\ProM\sources\org\processmining\log\utils\TraceVariant.java", "Java", 5, 14, 4, 23
"c:\Users\zipasink\OneDrive\PhD\research\research-workspace\interactive-auto-mapping-tool\test-systems\ProM\sources\org\processmining\log\utils\TraceVariantByClassifier.java", "Java", 61, 0, 14, 75
"c:\Users\zipasink\OneDrive\PhD\research\research-workspace\interactive-auto-mapping-tool\test-systems\ProM\sources\org\processmining\log\utils\XLogBuilder.java", "Java", 138, 81, 27, 246
"c:\Users\zipasink\OneDrive\PhD\research\research-workspace\interactive-auto-mapping-tool\test-systems\ProM\sources\org\processmining\log\utils\XUtils.java", "Java", 510, 247, 71, 828
"c:\Users\zipasink\OneDrive\PhD\research\research-workspace\interactive-auto-mapping-tool\test-systems\ProM\sources\org\processmining\log\xes\extensions\id\IdentitiesMissingException.java", "Java", 14, 3, 10, 27
"c:\Users\zipasink\OneDrive\PhD\research\research-workspace\interactive-auto-mapping-tool\test-systems\ProM\sources\org\processmining\log\xes\extensions\id\IdentityConnection.java", "Java", 40, 9, 19, 68
"c:\Users\zipasink\OneDrive\PhD\research\research-workspace\interactive-auto-mapping-tool\test-systems\ProM\sources\org\processmining\log\xes\extensions\id\IdentityMappingVisitor.java", "Java", 61, 6, 15, 82
"c:\Users\zipasink\OneDrive\PhD\research\research-workspace\interactive-auto-mapping-tool\test-systems\ProM\sources\org\processmining\log\xpath\engine\XPathEngine.java", "Java", 190, 20, 64, 274
"c:\Users\zipasink\OneDrive\PhD\research\research-workspace\interactive-auto-mapping-tool\test-systems\ProM\sources\org\processmining\log\xpath\engine\ui\XPathExecutor.java", "Java", 33, 7, 9, 49
"c:\Users\zipasink\OneDrive\PhD\research\research-workspace\interactive-auto-mapping-tool\test-systems\ProM\sources\org\processmining\log\xpath\engine\ui\XPathExecutorPanel.java", "Java", 426, 9, 142, 577
"c:\Users\zipasink\OneDrive\PhD\research\research-workspace\interactive-auto-mapping-tool\test-systems\ProM\sources\org\processmining\log\xsl\transformer\XSLTTransformer.java", "Java", 17, 0, 16, 33
"c:\Users\zipasink\OneDrive\PhD\research\research-workspace\interactive-auto-mapping-tool\test-systems\ProM\sources\org\processmining\logskeleton\algorithms\LogPartitionerAlgorithm.java", "Java", 115, 0, 8, 123
"c:\Users\zipasink\OneDrive\PhD\research\research-workspace\interactive-auto-mapping-tool\test-systems\ProM\sources\org\processmining\logskeleton\algorithms\LogPreprocessorAlgorithm.java", "Java", 11, 0, 5, 16
"c:\Users\zipasink\OneDrive\PhD\research\research-workspace\interactive-auto-mapping-tool\test-systems\ProM\sources\org\processmining\logskeleton\algorithms\LogSkeletonBuilderAlgorithm.java", "Java", 149, 0, 13, 162
"c:\Users\zipasink\OneDrive\PhD\research\research-workspace\interactive-auto-mapping-tool\test-systems\ProM\sources\org\processmining\logskeleton\algorithms\LogSkeletonCheckerAlgorithm.java", "Java", 26, 0, 6, 32
"c:\Users\zipasink\OneDrive\PhD\research\research-workspace\interactive-auto-mapping-tool\test-systems\ProM\sources\org\processmining\logskeleton\algorithms\LogSkeletonClassifierAlgorithm.java", "Java", 297, 24, 17, 338
"c:\Users\zipasink\OneDrive\PhD\research\research-workspace\interactive-auto-mapping-tool\test-systems\ProM\sources\org\processmining\logskeleton\algorithms\SplitterAlgorithm.java", "Java", 144, 3, 8, 155
"c:\Users\zipasink\OneDrive\PhD\research\research-workspace\interactive-auto-mapping-tool\test-systems\ProM\sources\org\processmining\logskeleton\classifiers\LogSkeletonClassifier.java", "Java", 35, 0, 13, 48
"c:\Users\zipasink\OneDrive\PhD\research\research-workspace\interactive-auto-mapping-tool\test-systems\ProM\sources\org\processmining\logskeleton\models\ClassificationProblem.java", "Java", 22, 0, 10, 32
"c:\Users\zipasink\OneDrive\PhD\research\research-workspace\interactive-auto-mapping-tool\test-systems\ProM\sources\org\processmining\logskeleton\models\LogSkeleton.java", "Java", 1272, 254, 87, 1613
"c:\Users\zipasink\OneDrive\PhD\research\research-workspace\interactive-auto-mapping-tool\test-systems\ProM\sources\org\processmining\logskeleton\models\LogSkeletonCount.java", "Java", 198, 23, 29, 250
"c:\Users\zipasink\OneDrive\PhD\research\research-workspace\interactive-auto-mapping-tool\test-systems\ProM\sources\org\processmining\logskeleton\models\ThresholdSet.java", "Java", 123, 5, 25, 153
"c:\Users\zipasink\OneDrive\PhD\research\research-workspace\interactive-auto-mapping-tool\test-systems\ProM\sources\org\processmining\logskeleton\parameters\LogSkeletonBrowser.java", "Java", 15, 8, 6, 29
"c:\Users\zipasink\OneDrive\PhD\research\research-workspace\interactive-auto-mapping-tool\test-systems\ProM\sources\org\processmining\logskeleton\parameters\LogSkeletonBrowserParameters.java", "Java", 91, 3, 25, 119
"c:\Users\zipasink\OneDrive\PhD\research\research-workspace\interactive-auto-mapping-tool\test-systems\ProM\sources\org\processmining\logskeleton\parameters\SplitterParameters.java", "Java", 19, 0, 7, 26
"c:\Users\zipasink\OneDrive\PhD\research\research-workspace\interactive-auto-mapping-tool\test-systems\ProM\sources\org\processmining\logskeleton\pdc2016\dialogs\PDC2016TestDialog.java", "Java", 77, 3, 11, 91
"c:\Users\zipasink\OneDrive\PhD\research\research-workspace\interactive-auto-mapping-tool\test-systems\ProM\sources\org\processmining\logskeleton\pdc2016\models\PDC2016TestModel.java", "Java", 88, 0, 9, 97
"c:\Users\zipasink\OneDrive\PhD\research\research-workspace\interactive-auto-mapping-tool\test-systems\ProM\sources\org\processmining\logskeleton\pdc2016\parameters\PDC2016TestParameters.java", "Java", 49, 0, 17, 66
"c:\Users\zipasink\OneDrive\PhD\research\research-workspace\interactive-auto-mapping-tool\test-systems\ProM\sources\org\processmining\logskeleton\pdc2016\plugins\PDC2016TestPlugin.java", "Java", 79, 1, 10, 90
"c:\Users\zipasink\OneDrive\PhD\research\research-workspace\interactive-auto-mapping-tool\test-systems\ProM\sources\org\processmining\logskeleton\pdc2017\algorithms\PDC2017LogPreprocessorAlgorithm.java", "Java", 123, 10, 16, 149
"c:\Users\zipasink\OneDrive\PhD\research\research-workspace\interactive-auto-mapping-tool\test-systems\ProM\sources\org\processmining\logskeleton\pdc2017\dialogs\PDC2017TestDialog.java", "Java", 109, 3, 12, 124
"c:\Users\zipasink\OneDrive\PhD\research\research-workspace\interactive-auto-mapping-tool\test-systems\ProM\sources\org\processmining\logskeleton\pdc2017\models\PDC2017TestModel.java", "Java", 88, 0, 9, 97
"c:\Users\zipasink\OneDrive\PhD\research\research-workspace\interactive-auto-mapping-tool\test-systems\ProM\sources\org\processmining\logskeleton\pdc2017\parameters\PDC2017TestParameters.java", "Java", 75, 0, 22, 97
"c:\Users\zipasink\OneDrive\PhD\research\research-workspace\interactive-auto-mapping-tool\test-systems\ProM\sources\org\processmining\logskeleton\pdc2017\plugins\PDC2017Log10FilterPlugin.java", "Java", 39, 0, 5, 44
"c:\Users\zipasink\OneDrive\PhD\research\research-workspace\interactive-auto-mapping-tool\test-systems\ProM\sources\org\processmining\logskeleton\pdc2017\plugins\PDC2017Log10SplitterPlugin.java", "Java", 54, 7, 6, 67
"c:\Users\zipasink\OneDrive\PhD\research\research-workspace\interactive-auto-mapping-tool\test-systems\ProM\sources\org\processmining\logskeleton\pdc2017\plugins\PDC2017Log1FilterPlugin.java", "Java", 51, 3, 5, 59
"c:\Users\zipasink\OneDrive\PhD\research\research-workspace\interactive-auto-mapping-tool\test-systems\ProM\sources\org\processmining\logskeleton\pdc2017\plugins\PDC2017Log2FilterPlugin.java", "Java", 41, 0, 5, 46
"c:\Users\zipasink\OneDrive\PhD\research\research-workspace\interactive-auto-mapping-tool\test-systems\ProM\sources\org\processmining\logskeleton\pdc2017\plugins\PDC2017Log2SplitterPlugin.java", "Java", 33, 3, 5, 41
"c:\Users\zipasink\OneDrive\PhD\research\research-workspace\interactive-auto-mapping-tool\test-systems\ProM\sources\org\processmining\logskeleton\pdc2017\plugins\PDC2017Log4SplitterPlugin.java", "Java", 36, 4, 6, 46
"c:\Users\zipasink\OneDrive\PhD\research\research-workspace\interactive-auto-mapping-tool\test-systems\ProM\sources\org\processmining\logskeleton\pdc2017\plugins\PDC2017Log5FilterPlugin.java", "Java", 38, 0, 5, 43
"c:\Users\zipasink\OneDrive\PhD\research\research-workspace\interactive-auto-mapping-tool\test-systems\ProM\sources\org\processmining\logskeleton\pdc2017\plugins\PDC2017Log5SplitterPlugin.java", "Java", 47, 6, 5, 58
"c:\Users\zipasink\OneDrive\PhD\research\research-workspace\interactive-auto-mapping-tool\test-systems\ProM\sources\org\processmining\logskeleton\pdc2017\plugins\PDC2017Log7SplitterPlugin.java", "Java", 50, 8, 6, 64
"c:\Users\zipasink\OneDrive\PhD\research\research-workspace\interactive-auto-mapping-tool\test-systems\ProM\sources\org\processmining\logskeleton\pdc2017\plugins\PDC2017Log9FilterPlugin.java", "Java", 42, 0, 4, 46
"c:\Users\zipasink\OneDrive\PhD\research\research-workspace\interactive-auto-mapping-tool\test-systems\ProM\sources\org\processmining\logskeleton\pdc2017\plugins\PDC2017Log9SplitterPlugin.java", "Java", 58, 8, 6, 72
"c:\Users\zipasink\OneDrive\PhD\research\research-workspace\interactive-auto-mapping-tool\test-systems\ProM\sources\org\processmining\logskeleton\pdc2017\plugins\PDC2017TestPlugin.java", "Java", 80, 1, 10, 91
"c:\Users\zipasink\OneDrive\PhD\research\research-workspace\interactive-auto-mapping-tool\test-systems\ProM\sources\org\processmining\logskeleton\pdc2019\plugins\PDC2019Log1FilterPlugin.java", "Java", 57, 0, 5, 62
"c:\Users\zipasink\OneDrive\PhD\research\research-workspace\interactive-auto-mapping-tool\test-systems\ProM\sources\org\processmining\logskeleton\pdc2019\plugins\PDC2019Log2FilterPlugin.java", "Java", 39, 0, 5, 44
"c:\Users\zipasink\OneDrive\PhD\research\research-workspace\interactive-auto-mapping-tool\test-systems\ProM\sources\org\processmining\logskeleton\pdc2019\plugins\PDC2019Log3FilterPlugin.java", "Java", 60, 0, 5, 65
"c:\Users\zipasink\OneDrive\PhD\research\research-workspace\interactive-auto-mapping-tool\test-systems\ProM\sources\org\processmining\logskeleton\pdc2019\plugins\PDC2019Log4CheckerPlugin.java", "Java", 78, 1, 6, 85
"c:\Users\zipasink\OneDrive\PhD\research\research-workspace\interactive-auto-mapping-tool\test-systems\ProM\sources\org\processmining\logskeleton\pdc2019\plugins\PDC2019Log4FilterPlugin.java", "Java", 42, 0, 5, 47
"c:\Users\zipasink\OneDrive\PhD\research\research-workspace\interactive-auto-mapping-tool\test-systems\ProM\sources\org\processmining\logskeleton\pdc2019\plugins\PDC2019Log4SplitterPlugin.java", "Java", 21, 0, 5, 26
"c:\Users\zipasink\OneDrive\PhD\research\research-workspace\interactive-auto-mapping-tool\test-systems\ProM\sources\org\processmining\logskeleton\pdc2019\plugins\PDC2019Log9SplitterPlugin.java", "Java", 74, 12, 6, 92
"c:\Users\zipasink\OneDrive\PhD\research\research-workspace\interactive-auto-mapping-tool\test-systems\ProM\sources\org\processmining\logskeleton\plugins\LogPartitionerPlugin.java", "Java", 29, 0, 6, 35
"c:\Users\zipasink\OneDrive\PhD\research\research-workspace\interactive-auto-mapping-tool\test-systems\ProM\sources\org\processmining\logskeleton\plugins\LogSkeletonBrowserPlugin.java", "Java", 232, 25, 39, 296
"c:\Users\zipasink\OneDrive\PhD\research\research-workspace\interactive-auto-mapping-tool\test-systems\ProM\sources\org\processmining\logskeleton\plugins\LogSkeletonBuilderPlugin.java", "Java", 21, 0, 5, 26
"c:\Users\zipasink\OneDrive\PhD\research\research-workspace\interactive-auto-mapping-tool\test-systems\ProM\sources\org\processmining\logskeleton\plugins\LogSkeletonCheckerPlugin.java", "Java", 31, 0, 8, 39
"c:\Users\zipasink\OneDrive\PhD\research\research-workspace\interactive-auto-mapping-tool\test-systems\ProM\sources\org\processmining\logskeleton\plugins\LogSkeletonClassifierPlugin.java", "Java", 21, 0, 6, 27
"c:\Users\zipasink\OneDrive\PhD\research\research-workspace\interactive-auto-mapping-tool\test-systems\ProM\sources\org\processmining\logskeleton\plugins\LogSkeletonExportPlugin.java", "Java", 23, 0, 6, 29
"c:\Users\zipasink\OneDrive\PhD\research\research-workspace\interactive-auto-mapping-tool\test-systems\ProM\sources\org\processmining\logskeleton\plugins\LogSkeletonFilterBrowserPlugin.java", "Java", 251, 0, 31, 282
"c:\Users\zipasink\OneDrive\PhD\research\research-workspace\interactive-auto-mapping-tool\test-systems\ProM\sources\org\processmining\logskeleton\plugins\LogSkeletonImportPlugin.java", "Java", 27, 0, 9, 36
"c:\Users\zipasink\OneDrive\PhD\research\research-workspace\interactive-auto-mapping-tool\test-systems\ProM\sources\org\processmining\logskeleton\plugins\LogSkeletonVisualizerPlugin.java", "Java", 76, 0, 20, 96
"c:\Users\zipasink\OneDrive\PhD\research\research-workspace\interactive-auto-mapping-tool\test-systems\ProM\sources\org\processmining\models\Apache20License.java", "Java", 60, 1, 9, 70
"c:\Users\zipasink\OneDrive\PhD\research\research-workspace\interactive-auto-mapping-tool\test-systems\ProM\sources\org\processmining\models\ResourceType.java", "Java", 10, 0, 4, 14
"c:\Users\zipasink\OneDrive\PhD\research\research-workspace\interactive-auto-mapping-tool\test-systems\ProM\sources\org\processmining\models\connections\AbstractLogModelConnection.java", "Java", 116, 0, 20, 136
"c:\Users\zipasink\OneDrive\PhD\research\research-workspace\interactive-auto-mapping-tool\test-systems\ProM\sources\org\processmining\models\connections\GraphLayoutConnection.java", "Java", 164, 14, 49, 227
"c:\Users\zipasink\OneDrive\PhD\research\research-workspace\interactive-auto-mapping-tool\test-systems\ProM\sources\org\processmining\models\connections\LogDirectedGraphConnection.java", "Java", 25, 0, 7, 32
"c:\Users\zipasink\OneDrive\PhD\research\research-workspace\interactive-auto-mapping-tool\test-systems\ProM\sources\org\processmining\models\graphbased\AbstractGraph.java", "Java", 57, 18, 15, 90
"c:\Users\zipasink\OneDrive\PhD\research\research-workspace\interactive-auto-mapping-tool\test-systems\ProM\sources\org\processmining\models\graphbased\AbstractGraphEdge.java", "Java", 30, 3, 12, 45
"c:\Users\zipasink\OneDrive\PhD\research\research-workspace\interactive-auto-mapping-tool\test-systems\ProM\sources\org\processmining\models\graphbased\AbstractGraphElement.java", "Java", 16, 0, 8, 24
"c:\Users\zipasink\OneDrive\PhD\research\research-workspace\interactive-auto-mapping-tool\test-systems\ProM\sources\org\processmining\models\graphbased\AbstractGraphNode.java", "Java", 20, 0, 8, 28
"c:\Users\zipasink\OneDrive\PhD\research\research-workspace\interactive-auto-mapping-tool\test-systems\ProM\sources\org\processmining\models\graphbased\AttributeMap.java", "Java", 108, 28, 28, 164
"c:\Users\zipasink\OneDrive\PhD\research\research-workspace\interactive-auto-mapping-tool\test-systems\ProM\sources\org\processmining\models\graphbased\AttributeMapOwner.java", "Java", 4, 0, 4, 8
"c:\Users\zipasink\OneDrive\PhD\research\research-workspace\interactive-auto-mapping-tool\test-systems\ProM\sources\org\processmining\models\graphbased\EdgeID.java", "Java", 23, 0, 10, 33
"c:\Users\zipasink\OneDrive\PhD\research\research-workspace\interactive-auto-mapping-tool\test-systems\ProM\sources\org\processmining\models\graphbased\Expandable.java", "Java", 5, 9, 5, 19
"c:\Users\zipasink\OneDrive\PhD\research\research-workspace\interactive-auto-mapping-tool\test-systems\ProM\sources\org\processmining\models\graphbased\ExpansionListener.java", "Java", 19, 0, 10, 29
"c:\Users\zipasink\OneDrive\PhD\research\research-workspace\interactive-auto-mapping-tool\test-systems\ProM\sources\org\processmining\models\graphbased\NodeID.java", "Java", 23, 0, 10, 33
"c:\Users\zipasink\OneDrive\PhD\research\research-workspace\interactive-auto-mapping-tool\test-systems\ProM\sources\org\processmining\models\graphbased\ViewSpecificAttributeMap.java", "Java", 95, 9, 15, 119
"c:\Users\zipasink\OneDrive\PhD\research\research-workspace\interactive-auto-mapping-tool\test-systems\ProM\sources\org\processmining\models\graphbased\directed\AbstractDirectedGraph.java", "Java", 113, 8, 18, 139
"c:\Users\zipasink\OneDrive\PhD\research\research-workspace\interactive-auto-mapping-tool\test-systems\ProM\sources\org\processmining\models\graphbased\directed\AbstractDirectedGraphEdge.java", "Java", 26, 0, 8, 34
"c:\Users\zipasink\OneDrive\PhD\research\research-workspace\interactive-auto-mapping-tool\test-systems\ProM\sources\org\processmining\models\graphbased\directed\AbstractDirectedGraphNode.java", "Java", 12, 1, 8, 21
"c:\Users\zipasink\OneDrive\PhD\research\research-workspace\interactive-auto-mapping-tool\test-systems\ProM\sources\org\processmining\models\graphbased\directed\BoundaryDirectedGraphNode.java", "Java", 4, 8, 4, 16
"c:\Users\zipasink\OneDrive\PhD\research\research-workspace\interactive-auto-mapping-tool\test-systems\ProM\sources\org\processmining\models\graphbased\directed\ContainableDirectedGraphElement.java", "Java", 5, 7, 5, 17
"c:\Users\zipasink\OneDrive\PhD\research\research-workspace\interactive-auto-mapping-tool\test-systems\ProM\sources\org\processmining\models\graphbased\directed\ContainingDirectedGraphNode.java", "Java", 7, 6, 6, 19
"c:\Users\zipasink\OneDrive\PhD\research\research-workspace\interactive-auto-mapping-tool\test-systems\ProM\sources\org\processmining\models\graphbased\directed\DirectedGraph.java", "Java", 13, 5, 10, 28
"c:\Users\zipasink\OneDrive\PhD\research\research-workspace\interactive-auto-mapping-tool\test-systems\ProM\sources\org\processmining\models\graphbased\directed\DirectedGraphEdge.java", "Java", 13, 28, 9, 50
"c:\Users\zipasink\OneDrive\PhD\research\research-workspace\interactive-auto-mapping-tool\test-systems\ProM\sources\org\processmining\models\graphbased\directed\DirectedGraphElement.java", "Java", 8, 8, 6, 22
"c:\Users\zipasink\OneDrive\PhD\research\research-workspace\interactive-auto-mapping-tool\test-systems\ProM\sources\org\processmining\models\graphbased\directed\DirectedGraphElementWeights.java", "Java", 42, 53, 9, 104
"c:\Users\zipasink\OneDrive\PhD\research\research-workspace\interactive-auto-mapping-tool\test-systems\ProM\sources\org\processmining\models\graphbased\directed\DirectedGraphNode.java", "Java", 5, 0, 5, 10
"c:\Users\zipasink\OneDrive\PhD\research\research-workspace\interactive-auto-mapping-tool\test-systems\ProM\sources\org\processmining\models\graphbased\directed\analysis\ComponentFactory.java", "Java", 61, 90, 7, 158
"c:\Users\zipasink\OneDrive\PhD\research\research-workspace\interactive-auto-mapping-tool\test-systems\ProM\sources\org\processmining\models\graphbased\directed\analysis\ShortestPathFactory.java", "Java", 76, 30, 23, 129
"c:\Users\zipasink\OneDrive\PhD\research\research-workspace\interactive-auto-mapping-tool\test-systems\ProM\sources\org\processmining\models\graphbased\directed\analysis\ShortestPathInfo.java", "Java", 96, 14, 15, 125
"c:\Users\zipasink\OneDrive\PhD\research\research-workspace\interactive-auto-mapping-tool\test-systems\ProM\sources\org\processmining\models\graphbased\directed\utils\GraphIterator.java", "Java", 86, 15, 17, 118
"c:\Users\zipasink\OneDrive\PhD\research\research-workspace\interactive-auto-mapping-tool\test-systems\ProM\sources\org\processmining\models\graphbased\directed\utils\Node.java", "Java", 76, 65, 18, 159
"c:\Users\zipasink\OneDrive\PhD\research\research-workspace\interactive-auto-mapping-tool\test-systems\ProM\sources\org\processmining\models\graphbased\directedhypergraph\AbstractDirectedHypergraph.java", "Java", 77, 0, 21, 98
"c:\Users\zipasink\OneDrive\PhD\research\research-workspace\interactive-auto-mapping-tool\test-systems\ProM\sources\org\processmining\models\graphbased\directedhypergraph\AbstractDirectedHypergraphNode.java", "Java", 22, 0, 12, 34
"c:\Users\zipasink\OneDrive\PhD\research\research-workspace\interactive-auto-mapping-tool\test-systems\ProM\sources\org\processmining\models\graphbased\directedhypergraph\AbstractDirectedIncomingHyperedge.java", "Java", 47, 6, 9, 62
"c:\Users\zipasink\OneDrive\PhD\research\research-workspace\interactive-auto-mapping-tool\test-systems\ProM\sources\org\processmining\models\graphbased\directedhypergraph\AbstractDirectedOutgoingHyperedge.java", "Java", 47, 6, 9, 62
"c:\Users\zipasink\OneDrive\PhD\research\research-workspace\interactive-auto-mapping-tool\test-systems\ProM\sources\org\processmining\models\graphbased\directedhypergraph\DirectedHypergraph.java", "Java", 16, 0, 13, 29
"c:\Users\zipasink\OneDrive\PhD\research\research-workspace\interactive-auto-mapping-tool\test-systems\ProM\sources\org\processmining\models\graphbased\directedhypergraph\DirectedHypergraphElement.java", "Java", 8, 0, 6, 14
"c:\Users\zipasink\OneDrive\PhD\research\research-workspace\interactive-auto-mapping-tool\test-systems\ProM\sources\org\processmining\models\graphbased\directedhypergraph\DirectedHypergraphNode.java", "Java", 3, 0, 3, 6
"c:\Users\zipasink\OneDrive\PhD\research\research-workspace\interactive-auto-mapping-tool\test-systems\ProM\sources\org\processmining\models\graphbased\directedhypergraph\DirectedIncomingHyperedge.java", "Java", 7, 8, 6, 21
"c:\Users\zipasink\OneDrive\PhD\research\research-workspace\interactive-auto-mapping-tool\test-systems\ProM\sources\org\processmining\models\graphbased\directedhypergraph\DirectedOutgoingHyperedge.java", "Java", 7, 8, 5, 20
"c:\Users\zipasink\OneDrive\PhD\research\research-workspace\interactive-auto-mapping-tool\test-systems\ProM\sources\org\processmining\models\graphbased\undirected\AbstractUndirectedEdge.java", "Java", 18, 0, 7, 25
"c:\Users\zipasink\OneDrive\PhD\research\research-workspace\interactive-auto-mapping-tool\test-systems\ProM\sources\org\processmining\models\graphbased\undirected\AbstractUndirectedGraph.java", "Java", 40, 0, 14, 54
"c:\Users\zipasink\OneDrive\PhD\research\research-workspace\interactive-auto-mapping-tool\test-systems\ProM\sources\org\processmining\models\graphbased\undirected\AbstractUndirectedNode.java", "Java", 21, 0, 8, 29
"c:\Users\zipasink\OneDrive\PhD\research\research-workspace\interactive-auto-mapping-tool\test-systems\ProM\sources\org\processmining\models\graphbased\undirected\UndirectedGraph.java", "Java", 10, 0, 8, 18
"c:\Users\zipasink\OneDrive\PhD\research\research-workspace\interactive-auto-mapping-tool\test-systems\ProM\sources\org\processmining\models\graphbased\undirected\UndirectedGraphEdge.java", "Java", 5, 0, 5, 10
"c:\Users\zipasink\OneDrive\PhD\research\research-workspace\interactive-auto-mapping-tool\test-systems\ProM\sources\org\processmining\models\graphbased\undirected\UndirectedGraphElement.java", "Java", 8, 0, 8, 16
"c:\Users\zipasink\OneDrive\PhD\research\research-workspace\interactive-auto-mapping-tool\test-systems\ProM\sources\org\processmining\models\graphbased\undirected\UndirectedGraphNode.java", "Java", 3, 0, 3, 6
"c:\Users\zipasink\OneDrive\PhD\research\research-workspace\interactive-auto-mapping-tool\test-systems\ProM\sources\org\processmining\models\jgraph\ContextMenuCreator.java", "Java", 8, 0, 7, 15
"c:\Users\zipasink\OneDrive\PhD\research\research-workspace\interactive-auto-mapping-tool\test-systems\ProM\sources\org\processmining\models\jgraph\DirectedGraphEdgeForMultiGraph.java", "Java", 109, 1, 19, 129
"c:\Users\zipasink\OneDrive\PhD\research\research-workspace\interactive-auto-mapping-tool\test-systems\ProM\sources\org\processmining\models\jgraph\DirectedGraphElementForMultiEdge.java", "Java", 5, 0, 4, 9
"c:\Users\zipasink\OneDrive\PhD\research\research-workspace\interactive-auto-mapping-tool\test-systems\ProM\sources\org\processmining\models\jgraph\DirectedGraphNodeForMultiGraph.java", "Java", 50, 0, 14, 64
"c:\Users\zipasink\OneDrive\PhD\research\research-workspace\interactive-auto-mapping-tool\test-systems\ProM\sources\org\processmining\models\jgraph\JGraphFoldingManager.java", "Java", 60, 11, 11, 82
"c:\Users\zipasink\OneDrive\PhD\research\research-workspace\interactive-auto-mapping-tool\test-systems\ProM\sources\org\processmining\models\jgraph\ModelOwner.java", "Java", 4, 0, 4, 8
"c:\Users\zipasink\OneDrive\PhD\research\research-workspace\interactive-auto-mapping-tool\test-systems\ProM\sources\org\processmining\models\jgraph\ProMGraphModel.java", "Java", 78, 4, 27, 109
"c:\Users\zipasink\OneDrive\PhD\research\research-workspace\interactive-auto-mapping-tool\test-systems\ProM\sources\org\processmining\models\jgraph\ProMJGraph.java", "Java", 616, 58, 150, 824
"c:\Users\zipasink\OneDrive\PhD\research\research-workspace\interactive-auto-mapping-tool\test-systems\ProM\sources\org\processmining\models\jgraph\ProMJGraphVisualizer.java", "Java", 123, 7, 38, 168
"c:\Users\zipasink\OneDrive\PhD\research\research-workspace\interactive-auto-mapping-tool\test-systems\ProM\sources\org\processmining\models\jgraph\ProMLoopRouting.java", "Java", 12, 3, 7, 22
"c:\Users\zipasink\OneDrive\PhD\research\research-workspace\interactive-auto-mapping-tool\test-systems\ProM\sources\org\processmining\models\jgraph\elements\ProMGraphCell.java", "Java", 120, 8, 25, 153
"c:\Users\zipasink\OneDrive\PhD\research\research-workspace\interactive-auto-mapping-tool\test-systems\ProM\sources\org\processmining\models\jgraph\elements\ProMGraphEdge.java", "Java", 157, 8, 38, 203
"c:\Users\zipasink\OneDrive\PhD\research\research-workspace\interactive-auto-mapping-tool\test-systems\ProM\sources\org\processmining\models\jgraph\elements\ProMGraphElement.java", "Java", 8, 0, 7, 15
"c:\Users\zipasink\OneDrive\PhD\research\research-workspace\interactive-auto-mapping-tool\test-systems\ProM\sources\org\processmining\models\jgraph\elements\ProMGraphPort.java", "Java", 84, 9, 19, 112
"c:\Users\zipasink\OneDrive\PhD\research\research-workspace\interactive-auto-mapping-tool\test-systems\ProM\sources\org\processmining\models\jgraph\factory\ProMCellViewFactory.java", "Java", 64, 0, 14, 78
"c:\Users\zipasink\OneDrive\PhD\research\research-workspace\interactive-auto-mapping-tool\test-systems\ProM\sources\org\processmining\models\jgraph\listeners\SelectionListener.java", "Java", 33, 0, 12, 45
"c:\Users\zipasink\OneDrive\PhD\research\research-workspace\interactive-auto-mapping-tool\test-systems\ProM\sources\org\processmining\models\jgraph\renderers\ProMEdgeRenderer.java", "Java", 205, 35, 27, 267
"c:\Users\zipasink\OneDrive\PhD\research\research-workspace\interactive-auto-mapping-tool\test-systems\ProM\sources\org\processmining\models\jgraph\renderers\ProMGroupShapeRenderer.java", "Java", 53, 45, 14, 112
"c:\Users\zipasink\OneDrive\PhD\research\research-workspace\interactive-auto-mapping-tool\test-systems\ProM\sources\org\processmining\models\jgraph\renderers\ProMPortRenderer.java", "Java", 143, 3, 25, 171
"c:\Users\zipasink\OneDrive\PhD\research\research-workspace\interactive-auto-mapping-tool\test-systems\ProM\sources\org\processmining\models\jgraph\renderers\ProMShapeRenderer.java", "Java", 159, 51, 32, 242
"c:\Users\zipasink\OneDrive\PhD\research\research-workspace\interactive-auto-mapping-tool\test-systems\ProM\sources\org\processmining\models\jgraph\views\JGraphEdgeView.java", "Java", 65, 0, 15, 80
"c:\Users\zipasink\OneDrive\PhD\research\research-workspace\interactive-auto-mapping-tool\test-systems\ProM\sources\org\processmining\models\jgraph\views\JGraphPortView.java", "Java", 54, 0, 12, 66
"c:\Users\zipasink\OneDrive\PhD\research\research-workspace\interactive-auto-mapping-tool\test-systems\ProM\sources\org\processmining\models\jgraph\views\JGraphShapeView.java", "Java", 98, 7, 21, 126
"c:\Users\zipasink\OneDrive\PhD\research\research-workspace\interactive-auto-mapping-tool\test-systems\ProM\sources\org\processmining\models\jgraph\visualization\ProMJGraphPanel.java", "Java", 120, 13, 25, 158
"c:\Users\zipasink\OneDrive\PhD\research\research-workspace\interactive-auto-mapping-tool\test-systems\ProM\sources\org\processmining\models\semantics\ExecutionInformation.java", "Java", 3, 0, 3, 6
"c:\Users\zipasink\OneDrive\PhD\research\research-workspace\interactive-auto-mapping-tool\test-systems\ProM\sources\org\processmining\models\semantics\ExtendedSemantics.java", "Java", 4, 0, 4, 8
"c:\Users\zipasink\OneDrive\PhD\research\research-workspace\interactive-auto-mapping-tool\test-systems\ProM\sources\org\processmining\models\semantics\IllegalTransitionException.java", "Java", 10, 0, 5, 15
"c:\Users\zipasink\OneDrive\PhD\research\research-workspace\interactive-auto-mapping-tool\test-systems\ProM\sources\org\processmining\models\semantics\Semantics.java", "Java", 10, 9, 8, 27
"c:\Users\zipasink\OneDrive\PhD\research\research-workspace\interactive-auto-mapping-tool\test-systems\ProM\sources\org\processmining\models\shapes\AbstractShape.java", "Java", 52, 0, 11, 63
"c:\Users\zipasink\OneDrive\PhD\research\research-workspace\interactive-auto-mapping-tool\test-systems\ProM\sources\org\processmining\models\shapes\Decorated.java", "Java", 5, 0, 5, 10
"c:\Users\zipasink\OneDrive\PhD\research\research-workspace\interactive-auto-mapping-tool\test-systems\ProM\sources\org\processmining\models\shapes\Diamond.java", "Java", 12, 0, 5, 17
"c:\Users\zipasink\OneDrive\PhD\research\research-workspace\interactive-auto-mapping-tool\test-systems\ProM\sources\org\processmining\models\shapes\Ellipse.java", "Java", 52, 7, 23, 82
"c:\Users\zipasink\OneDrive\PhD\research\research-workspace\interactive-auto-mapping-tool\test-systems\ProM\sources\org\processmining\models\shapes\Gate.java", "Java", 29, 3, 14, 46
"c:\Users\zipasink\OneDrive\PhD\research\research-workspace\interactive-auto-mapping-tool\test-systems\ProM\sources\org\processmining\models\shapes\Hexagon.java", "Java", 19, 0, 8, 27
"c:\Users\zipasink\OneDrive\PhD\research\research-workspace\interactive-auto-mapping-tool\test-systems\ProM\sources\org\processmining\models\shapes\Octagon.java", "Java", 21, 0, 7, 28
"c:\Users\zipasink\OneDrive\PhD\research\research-workspace\interactive-auto-mapping-tool\test-systems\ProM\sources\org\processmining\models\shapes\Polygon.java", "Java", 33, 4, 16, 53
"c:\Users\zipasink\OneDrive\PhD\research\research-workspace\interactive-auto-mapping-tool\test-systems\ProM\sources\org\processmining\models\shapes\Rectangle.java", "Java", 25, 1, 10, 36
"c:\Users\zipasink\OneDrive\PhD\research\research-workspace\interactive-auto-mapping-tool\test-systems\ProM\sources\org\processmining\models\shapes\RoundedRect.java", "Java", 12, 11, 8, 31
"c:\Users\zipasink\OneDrive\PhD\research\research-workspace\interactive-auto-mapping-tool\test-systems\ProM\sources\org\processmining\models\shapes\Shape.java", "Java", 8, 0, 6, 14
"c:\Users\zipasink\OneDrive\PhD\research\research-workspace\interactive-auto-mapping-tool\test-systems\ProM\sources\org\processmining\models\util\AbstractSelectionPanel.java", "Java", 115, 9, 26, 150
"c:\Users\zipasink\OneDrive\PhD\research\research-workspace\interactive-auto-mapping-tool\test-systems\ProM\sources\org\processmining\models\util\ListSelectionPanel.java", "Java", 190, 16, 36, 242
"c:\Users\zipasink\OneDrive\PhD\research\research-workspace\interactive-auto-mapping-tool\test-systems\ProM\sources\org\processmining\plugins\Apache20LicensePlugin.java", "Java", 15, 0, 4, 19
"c:\Users\zipasink\OneDrive\PhD\research\research-workspace\interactive-auto-mapping-tool\test-systems\ProM\sources\org\processmining\plugins\HelloWorld.java", "Java", 22, 0, 2, 24
"c:\Users\zipasink\OneDrive\PhD\research\research-workspace\interactive-auto-mapping-tool\test-systems\ProM\sources\org\processmining\plugins\ShowPackageOverviewPlugin.java", "Java", 191, 0, 11, 202
"c:\Users\zipasink\OneDrive\PhD\research\research-workspace\interactive-auto-mapping-tool\test-systems\ProM\sources\org\processmining\plugins\graphviz\colourMaps\ColourMap.java", "Java", 40, 0, 11, 51
"c:\Users\zipasink\OneDrive\PhD\research\research-workspace\interactive-auto-mapping-tool\test-systems\ProM\sources\org\processmining\plugins\graphviz\colourMaps\ColourMapBlackBody.java", "Java", 10, 0, 6, 16
"c:\Users\zipasink\OneDrive\PhD\research\research-workspace\interactive-auto-mapping-tool\test-systems\ProM\sources\org\processmining\plugins\graphviz\colourMaps\ColourMapBlue.java", "Java", 10, 0, 6, 16
"c:\Users\zipasink\OneDrive\PhD\research\research-workspace\interactive-auto-mapping-tool\test-systems\ProM\sources\org\processmining\plugins\graphviz\colourMaps\ColourMapFixed.java", "Java", 14, 0, 6, 20
"c:\Users\zipasink\OneDrive\PhD\research\research-workspace\interactive-auto-mapping-tool\test-systems\ProM\sources\org\processmining\plugins\graphviz\colourMaps\ColourMapFixedOpacity.java", "Java", 18, 0, 7, 25
"c:\Users\zipasink\OneDrive\PhD\research\research-workspace\interactive-auto-mapping-tool\test-systems\ProM\sources\org\processmining\plugins\graphviz\colourMaps\ColourMapGreen.java", "Java", 10, 0, 6, 16
"c:\Users\zipasink\OneDrive\PhD\research\research-workspace\interactive-auto-mapping-tool\test-systems\ProM\sources\org\processmining\plugins\graphviz\colourMaps\ColourMapGreyBlack.java", "Java", 10, 0, 6, 16
"c:\Users\zipasink\OneDrive\PhD\research\research-workspace\interactive-auto-mapping-tool\test-systems\ProM\sources\org\processmining\plugins\graphviz\colourMaps\ColourMapInterpolate.java", "Java", 24, 6, 8, 38
"c:\Users\zipasink\OneDrive\PhD\research\research-workspace\interactive-auto-mapping-tool\test-systems\ProM\sources\org\processmining\plugins\graphviz\colourMaps\ColourMapLightBlue.java", "Java", 13, 0, 7, 20
"c:\Users\zipasink\OneDrive\PhD\research\research-workspace\interactive-auto-mapping-tool\test-systems\ProM\sources\org\processmining\plugins\graphviz\colourMaps\ColourMapOpacity.java", "Java", 17, 0, 7, 24
"c:\Users\zipasink\OneDrive\PhD\research\research-workspace\interactive-auto-mapping-tool\test-systems\ProM\sources\org\processmining\plugins\graphviz\colourMaps\ColourMapRed.java", "Java", 10, 0, 6, 16
"c:\Users\zipasink\OneDrive\PhD\research\research-workspace\interactive-auto-mapping-tool\test-systems\ProM\sources\org\processmining\plugins\graphviz\colourMaps\ColourMapViridis.java", "Java", 134, 0, 3, 137
"c:\Users\zipasink\OneDrive\PhD\research\research-workspace\interactive-auto-mapping-tool\test-systems\ProM\sources\org\processmining\plugins\graphviz\colourMaps\ColourMapWhiteRed.java", "Java", 11, 0, 4, 15
"c:\Users\zipasink\OneDrive\PhD\research\research-workspace\interactive-auto-mapping-tool\test-systems\ProM\sources\org\processmining\plugins\graphviz\colourMaps\ColourMaps.java", "Java", 59, 10, 20, 89
"c:\Users\zipasink\OneDrive\PhD\research\research-workspace\interactive-auto-mapping-tool\test-systems\ProM\sources\org\processmining\plugins\graphviz\dot\AbstractDotElement.java", "Java", 101, 1, 24, 126
"c:\Users\zipasink\OneDrive\PhD\research\research-workspace\interactive-auto-mapping-tool\test-systems\ProM\sources\org\processmining\plugins\graphviz\dot\Dot.java", "Java", 78, 0, 23, 101
"c:\Users\zipasink\OneDrive\PhD\research\research-workspace\interactive-auto-mapping-tool\test-systems\ProM\sources\org\processmining\plugins\graphviz\dot\Dot2Image.java", "Java", 190, 9, 32, 231
"c:\Users\zipasink\OneDrive\PhD\research\research-workspace\interactive-auto-mapping-tool\test-systems\ProM\sources\org\processmining\plugins\graphviz\dot\DotCluster.java", "Java", 219, 192, 54, 465
"c:\Users\zipasink\OneDrive\PhD\research\research-workspace\interactive-auto-mapping-tool\test-systems\ProM\sources\org\processmining\plugins\graphviz\dot\DotEdge.java", "Java", 57, 7, 15, 79
"c:\Users\zipasink\OneDrive\PhD\research\research-workspace\interactive-auto-mapping-tool\test-systems\ProM\sources\org\processmining\plugins\graphviz\dot\DotElement.java", "Java", 18, 65, 17, 100
"c:\Users\zipasink\OneDrive\PhD\research\research-workspace\interactive-auto-mapping-tool\test-systems\ProM\sources\org\processmining\plugins\graphviz\dot\DotNode.java", "Java", 26, 0, 7, 33
"c:\Users\zipasink\OneDrive\PhD\research\research-workspace\interactive-auto-mapping-tool\test-systems\ProM\sources\org\processmining\plugins\graphviz\dot\plugins\DotEMFExportPlugin.java", "Java", 21, 6, 4, 31
"c:\Users\zipasink\OneDrive\PhD\research\research-workspace\interactive-auto-mapping-tool\test-systems\ProM\sources\org\processmining\plugins\graphviz\dot\plugins\DotEPSExportPlugin.java", "Java", 21, 6, 4, 31
"c:\Users\zipasink\OneDrive\PhD\research\research-workspace\interactive-auto-mapping-tool\test-systems\ProM\sources\org\processmining\plugins\graphviz\dot\plugins\DotExportPlugin.java", "Java", 24, 6, 4, 34
"c:\Users\zipasink\OneDrive\PhD\research\research-workspace\interactive-auto-mapping-tool\test-systems\ProM\sources\org\processmining\plugins\graphviz\dot\plugins\DotImageExportPlugin.java", "Java", 22, 0, 6, 28
"c:\Users\zipasink\OneDrive\PhD\research\research-workspace\interactive-auto-mapping-tool\test-systems\ProM\sources\org\processmining\plugins\graphviz\dot\plugins\DotPDFExportPlugin.java", "Java", 21, 6, 5, 32
"c:\Users\zipasink\OneDrive\PhD\research\research-workspace\interactive-auto-mapping-tool\test-systems\ProM\sources\org\processmining\plugins\graphviz\dot\plugins\DotPNGExportPlugin.java", "Java", 21, 6, 4, 31
"c:\Users\zipasink\OneDrive\PhD\research\research-workspace\interactive-auto-mapping-tool\test-systems\ProM\sources\org\processmining\plugins\graphviz\dot\plugins\DotSVGExportPlugin.java", "Java", 21, 6, 4, 31
"c:\Users\zipasink\OneDrive\PhD\research\research-workspace\interactive-auto-mapping-tool\test-systems\ProM\sources\org\processmining\plugins\graphviz\visualisation\DotPanel.java", "Java", 461, 91, 77, 629
"c:\Users\zipasink\OneDrive\PhD\research\research-workspace\interactive-auto-mapping-tool\test-systems\ProM\sources\org\processmining\plugins\graphviz\visualisation\DotPanelUserSettings.java", "Java", 31, 11, 10, 52
"c:\Users\zipasink\OneDrive\PhD\research\research-workspace\interactive-auto-mapping-tool\test-systems\ProM\sources\org\processmining\plugins\graphviz\visualisation\DotVisualisation.java", "Java", 16, 0, 6, 22
"c:\Users\zipasink\OneDrive\PhD\research\research-workspace\interactive-auto-mapping-tool\test-systems\ProM\sources\org\processmining\plugins\graphviz\visualisation\NavigableSVGPanel.java", "Java", 865, 340, 184, 1389
"c:\Users\zipasink\OneDrive\PhD\research\research-workspace\interactive-auto-mapping-tool\test-systems\ProM\sources\org\processmining\plugins\graphviz\visualisation\export\ExportDialog.java", "Java", 50, 2, 12, 64
"c:\Users\zipasink\OneDrive\PhD\research\research-workspace\interactive-auto-mapping-tool\test-systems\ProM\sources\org\processmining\plugins\graphviz\visualisation\export\Exporter.java", "Java", 26, 0, 10, 36
"c:\Users\zipasink\OneDrive\PhD\research\research-workspace\interactive-auto-mapping-tool\test-systems\ProM\sources\org\processmining\plugins\graphviz\visualisation\export\ExporterDot.java", "Java", 21, 0, 7, 28
"c:\Users\zipasink\OneDrive\PhD\research\research-workspace\interactive-auto-mapping-tool\test-systems\ProM\sources\org\processmining\plugins\graphviz\visualisation\export\ExporterEMF.java", "Java", 22, 0, 8, 30
"c:\Users\zipasink\OneDrive\PhD\research\research-workspace\interactive-auto-mapping-tool\test-systems\ProM\sources\org\processmining\plugins\graphviz\visualisation\export\ExporterEPS.java", "Java", 26, 0, 8, 34
"c:\Users\zipasink\OneDrive\PhD\research\research-workspace\interactive-auto-mapping-tool\test-systems\ProM\sources\org\processmining\plugins\graphviz\visualisation\export\ExporterPDF.java", "Java", 27, 7, 12, 46
"c:\Users\zipasink\OneDrive\PhD\research\research-workspace\interactive-auto-mapping-tool\test-systems\ProM\sources\org\processmining\plugins\graphviz\visualisation\export\ExporterPNG.java", "Java", 20, 0, 8, 28
"c:\Users\zipasink\OneDrive\PhD\research\research-workspace\interactive-auto-mapping-tool\test-systems\ProM\sources\org\processmining\plugins\graphviz\visualisation\export\ExporterSVG.java", "Java", 23, 0, 8, 31
"c:\Users\zipasink\OneDrive\PhD\research\research-workspace\interactive-auto-mapping-tool\test-systems\ProM\sources\org\processmining\plugins\graphviz\visualisation\listeners\DotElementSelectionListener.java", "Java", 7, 0, 4, 11
"c:\Users\zipasink\OneDrive\PhD\research\research-workspace\interactive-auto-mapping-tool\test-systems\ProM\sources\org\processmining\plugins\graphviz\visualisation\listeners\ElementSelectionListener.java", "Java", 6, 0, 2, 8
"c:\Users\zipasink\OneDrive\PhD\research\research-workspace\interactive-auto-mapping-tool\test-systems\ProM\sources\org\processmining\plugins\graphviz\visualisation\listeners\GraphChangedListener.java", "Java", 7, 0, 4, 11
"c:\Users\zipasink\OneDrive\PhD\research\research-workspace\interactive-auto-mapping-tool\test-systems\ProM\sources\org\processmining\plugins\graphviz\visualisation\listeners\ImageTransformationChangedListener.java", "Java", 5, 0, 3, 8
"c:\Users\zipasink\OneDrive\PhD\research\research-workspace\interactive-auto-mapping-tool\test-systems\ProM\sources\org\processmining\plugins\graphviz\visualisation\listeners\MouseInElementsChangedListener.java", "Java", 5, 4, 3, 12
"c:\Users\zipasink\OneDrive\PhD\research\research-workspace\interactive-auto-mapping-tool\test-systems\ProM\sources\org\processmining\plugins\graphviz\visualisation\listeners\SelectionChangedListener.java", "Java", 5, 4, 4, 13
"c:\Users\zipasink\OneDrive\PhD\research\research-workspace\interactive-auto-mapping-tool\test-systems\ProM\sources\org\processmining\plugins\log\OpenBufferedLogFilePlugin.java", "Java", 10, 2, 4, 16
"c:\Users\zipasink\OneDrive\PhD\research\research-workspace\interactive-auto-mapping-tool\test-systems\ProM\sources\org\processmining\plugins\log\OpenLogFilePlugin.java", "Java", 96, 64, 17, 177
"c:\Users\zipasink\OneDrive\PhD\research\research-workspace\interactive-auto-mapping-tool\test-systems\ProM\sources\org\processmining\plugins\log\OpenNaiveLogFilePlugin.java", "Java", 16, 0, 4, 20
"c:\Users\zipasink\OneDrive\PhD\research\research-workspace\interactive-auto-mapping-tool\test-systems\ProM\sources\org\processmining\plugins\log\ReSortLog.java", "Java", 41, 0, 12, 53
"c:\Users\zipasink\OneDrive\PhD\research\research-workspace\interactive-auto-mapping-tool\test-systems\ProM\sources\org\processmining\plugins\log\XContextMonitoredInputStream.java", "Java", 24, 0, 9, 33
"c:\Users\zipasink\OneDrive\PhD\research\research-workspace\interactive-auto-mapping-tool\test-systems\ProM\sources\org\processmining\plugins\log\exporting\AbstractLogExporter.java", "Java", 21, 18, 6, 45
"c:\Users\zipasink\OneDrive\PhD\research\research-workspace\interactive-auto-mapping-tool\test-systems\ProM\sources\org\processmining\plugins\log\exporting\ExportLogMxml.java", "Java", 31, 0, 7, 38
"c:\Users\zipasink\OneDrive\PhD\research\research-workspace\interactive-auto-mapping-tool\test-systems\ProM\sources\org\processmining\plugins\log\exporting\ExportLogMxmlGz.java", "Java", 32, 0, 6, 38
"c:\Users\zipasink\OneDrive\PhD\research\research-workspace\interactive-auto-mapping-tool\test-systems\ProM\sources\org\processmining\plugins\log\exporting\ExportLogXes.java", "Java", 31, 1, 7, 39
"c:\Users\zipasink\OneDrive\PhD\research\research-workspace\interactive-auto-mapping-tool\test-systems\ProM\sources\org\processmining\plugins\log\exporting\ExportLogXesGz.java", "Java", 31, 0, 6, 37
"c:\Users\zipasink\OneDrive\PhD\research\research-workspace\interactive-auto-mapping-tool\test-systems\ProM\sources\org\processmining\plugins\log\filter\AttributeLogFilter.java", "Java", 85, 1, 20, 106
"c:\Users\zipasink\OneDrive\PhD\research\research-workspace\interactive-auto-mapping-tool\test-systems\ProM\sources\org\processmining\plugins\log\filter\AttributeLogFilterPlugin.java", "Java", 67, 3, 16, 86
"c:\Users\zipasink\OneDrive\PhD\research\research-workspace\interactive-auto-mapping-tool\test-systems\ProM\sources\org\processmining\plugins\log\filter\AttributeLogFilter_UI.java", "Java", 242, 58, 53, 353
"c:\Users\zipasink\OneDrive\PhD\research\research-workspace\interactive-auto-mapping-tool\test-systems\ProM\sources\org\processmining\plugins\log\logclassifiers\BasicEventClassifier.java", "Java", 23, 0, 7, 30
"c:\Users\zipasink\OneDrive\PhD\research\research-workspace\interactive-auto-mapping-tool\test-systems\ProM\sources\org\processmining\plugins\log\logclassifiers\EventAndClassifier.java", "Java", 11, 0, 5, 16
"c:\Users\zipasink\OneDrive\PhD\research\research-workspace\interactive-auto-mapping-tool\test-systems\ProM\sources\org\processmining\plugins\log\logfilters\AttributeFilterDialog.java", "Java", 97, 3, 19, 119
"c:\Users\zipasink\OneDrive\PhD\research\research-workspace\interactive-auto-mapping-tool\test-systems\ProM\sources\org\processmining\plugins\log\logfilters\AttributeFilterParameters.java", "Java", 66, 0, 15, 81
"c:\Users\zipasink\OneDrive\PhD\research\research-workspace\interactive-auto-mapping-tool\test-systems\ProM\sources\org\processmining\plugins\log\logfilters\AttributeFilterPlugin.java", "Java", 72, 0, 6, 78
"c:\Users\zipasink\OneDrive\PhD\research\research-workspace\interactive-auto-mapping-tool\test-systems\ProM\sources\org\processmining\plugins\log\logfilters\LogFilter.java", "Java", 190, 303, 34, 527
"c:\Users\zipasink\OneDrive\PhD\research\research-workspace\interactive-auto-mapping-tool\test-systems\ProM\sources\org\processmining\plugins\log\logfilters\LogFilterException.java", "Java", 7, 3, 3, 13
"c:\Users\zipasink\OneDrive\PhD\research\research-workspace\interactive-auto-mapping-tool\test-systems\ProM\sources\org\processmining\plugins\log\logfilters\TraceAttributeFilterParameters.java", "Java", 28, 0, 5, 33
"c:\Users\zipasink\OneDrive\PhD\research\research-workspace\interactive-auto-mapping-tool\test-systems\ProM\sources\org\processmining\plugins\log\logfilters\TraceAttributeFilterPlugin.java", "Java", 64, 0, 6, 70
"c:\Users\zipasink\OneDrive\PhD\research\research-workspace\interactive-auto-mapping-tool\test-systems\ProM\sources\org\processmining\plugins\log\logfilters\XEventCondition.java", "Java", 5, 18, 4, 27
"c:\Users\zipasink\OneDrive\PhD\research\research-workspace\interactive-auto-mapping-tool\test-systems\ProM\sources\org\processmining\plugins\log\logfilters\XEventEditor.java", "Java", 5, 20, 5, 30
"c:\Users\zipasink\OneDrive\PhD\research\research-workspace\interactive-auto-mapping-tool\test-systems\ProM\sources\org\processmining\plugins\log\logfilters\XTraceCondition.java", "Java", 5, 19, 4, 28
"c:\Users\zipasink\OneDrive\PhD\research\research-workspace\interactive-auto-mapping-tool\test-systems\ProM\sources\org\processmining\plugins\log\logfilters\XTraceEditor.java", "Java", 5, 19, 5, 29
"c:\Users\zipasink\OneDrive\PhD\research\research-workspace\interactive-auto-mapping-tool\test-systems\ProM\sources\org\processmining\plugins\log\logfilters\impl\AddArtificialEndFilter.java", "Java", 24, 15, 5, 44
"c:\Users\zipasink\OneDrive\PhD\research\research-workspace\interactive-auto-mapping-tool\test-systems\ProM\sources\org\processmining\plugins\log\logfilters\impl\AddArtificialStartFilter.java", "Java", 24, 16, 6, 46
"c:\Users\zipasink\OneDrive\PhD\research\research-workspace\interactive-auto-mapping-tool\test-systems\ProM\sources\org\processmining\plugins\log\logfilters\impl\DayAbstractionLogEditor.java", "Java", 33, 5, 10, 48
"c:\Users\zipasink\OneDrive\PhD\research\research-workspace\interactive-auto-mapping-tool\test-systems\ProM\sources\org\processmining\plugins\log\logfilters\impl\DefaultLogFilter.java", "Java", 51, 22, 9, 82
"c:\Users\zipasink\OneDrive\PhD\research\research-workspace\interactive-auto-mapping-tool\test-systems\ProM\sources\org\processmining\plugins\log\logfilters\impl\DuplicateEventLogFilter.java", "Java", 30, 21, 6, 57
"c:\Users\zipasink\OneDrive\PhD\research\research-workspace\interactive-auto-mapping-tool\test-systems\ProM\sources\org\processmining\plugins\log\logfilters\impl\EventLogFilter.java", "Java", 105, 117, 28, 250
"c:\Users\zipasink\OneDrive\PhD\research\research-workspace\interactive-auto-mapping-tool\test-systems\ProM\sources\org\processmining\plugins\log\logfilters\impl\FinalEventLogFilter.java", "Java", 38, 18, 11, 67
"c:\Users\zipasink\OneDrive\PhD\research\research-workspace\interactive-auto-mapping-tool\test-systems\ProM\sources\org\processmining\plugins\log\logfilters\impl\FirstSixMonthsFilter.java", "Java", 38, 0, 6, 44
"c:\Users\zipasink\OneDrive\PhD\research\research-workspace\interactive-auto-mapping-tool\test-systems\ProM\sources\org\processmining\plugins\log\logfilters\impl\OriginatorLogFilter.java", "Java", 57, 125, 16, 198
"c:\Users\zipasink\OneDrive\PhD\research\research-workspace\interactive-auto-mapping-tool\test-systems\ProM\sources\org\processmining\plugins\log\logfilters\impl\StartEventLogFilter.java", "Java", 38, 18, 11, 67
"c:\Users\zipasink\OneDrive\PhD\research\research-workspace\interactive-auto-mapping-tool\test-systems\ProM\sources\org\processmining\plugins\log\logfilters\impl\WeekAbstractionLogEditor.java", "Java", 33, 5, 10, 48
"c:\Users\zipasink\OneDrive\PhD\research\research-workspace\interactive-auto-mapping-tool\test-systems\ProM\sources\org\processmining\plugins\log\logfilters\ui\LogFilterPlugin.java", "Java", 26, 0, 4, 30
"c:\Users\zipasink\OneDrive\PhD\research\research-workspace\interactive-auto-mapping-tool\test-systems\ProM\sources\org\processmining\plugins\log\logfilters\ui\LogFilterUI.java", "Java", 370, 237, 57, 664
"c:\Users\zipasink\OneDrive\PhD\research\research-workspace\interactive-auto-mapping-tool\test-systems\ProM\sources\org\processmining\plugins\log\logfilters\ui\SlickerEventTypeConfiguration.java", "Java", 141, 8, 21, 170
"c:\Users\zipasink\OneDrive\PhD\research\research-workspace\interactive-auto-mapping-tool\test-systems\ProM\sources\org\processmining\plugins\log\reverse\TraceReverser.java", "Java", 65, 6, 7, 78
"c:\Users\zipasink\OneDrive\PhD\research\research-workspace\interactive-auto-mapping-tool\test-systems\ProM\sources\org\processmining\plugins\loginsertstart\AddSt.java", "Java", 91, 40, 30, 161
"c:\Users\zipasink\OneDrive\PhD\research\research-workspace\interactive-auto-mapping-tool\test-systems\ProM\sources\org\processmining\plugins\loginsertstart\AddStEvents.java", "Java", 370, 67, 103, 540
"c:\Users\zipasink\OneDrive\PhD\research\research-workspace\interactive-auto-mapping-tool\test-systems\ProM\sources\org\processmining\plugins\loginsertstart\AddStMain.java", "Java", 82, 38, 22, 142
"c:\Users\zipasink\OneDrive\PhD\research\research-workspace\interactive-auto-mapping-tool\test-systems\ProM\sources\org\processmining\plugins\loginsertstart\AddStPanel.java", "Java", 111, 21, 45, 177
"c:\Users\zipasink\OneDrive\PhD\research\research-workspace\interactive-auto-mapping-tool\test-systems\ProM\sources\org\processmining\plugins\loginsertstart\AddStPlugin.java", "Java", 20, 16, 7, 43
"c:\Users\zipasink\OneDrive\PhD\research\research-workspace\interactive-auto-mapping-tool\test-systems\ProM\sources\org\processmining\plugins\loginsertstart\AddStSecPanel.java", "Java", 78, 9, 37, 124
"c:\Users\zipasink\OneDrive\PhD\research\research-workspace\interactive-auto-mapping-tool\test-systems\ProM\sources\org\processmining\plugins\loginsertstart\AddStVisualizer.java", "Java", 19, 9, 9, 37
"c:\Users\zipasink\OneDrive\PhD\research\research-workspace\interactive-auto-mapping-tool\test-systems\ProM\sources\org\processmining\plugins\loginsertstart\BoxandWhiskerPlot.java", "Java", 110, 6, 35, 151
"c:\Users\zipasink\OneDrive\PhD\research\research-workspace\interactive-auto-mapping-tool\test-systems\ProM\sources\org\processmining\plugins\loginsertstart\ObtainDurationWithStart.java", "Java", 73, 16, 19, 108
"c:\Users\zipasink\OneDrive\PhD\research\research-workspace\interactive-auto-mapping-tool\test-systems\ProM\sources\org\processmining\plugins\loginsertstart\ObtainDurationsWithoutStart.java", "Java", 148, 23, 41, 212
"c:\Users\zipasink\OneDrive\PhD\research\research-workspace\interactive-auto-mapping-tool\test-systems\ProM\sources\org\processmining\plugins\utils\ConnectionManagerHelper.java", "Java", 40, 30, 8, 78
"c:\Users\zipasink\OneDrive\PhD\research\research-workspace\interactive-auto-mapping-tool\test-systems\ProM\sources\org\processmining\plugins\utils\HammingDistance.java", "Java", 93, 52, 10, 155
"c:\Users\zipasink\OneDrive\PhD\research\research-workspace\interactive-auto-mapping-tool\test-systems\ProM\sources\org\processmining\plugins\utils\ProvidedObjectHelper.java", "Java", 132, 62, 13, 207
"c:\Users\zipasink\OneDrive\PhD\research\research-workspace\interactive-auto-mapping-tool\test-systems\ProM\sources\org\processmining\plugins\utils\sequencedistance\AbstractSequenceDistance.java", "Java", 13, 0, 6, 19
"c:\Users\zipasink\OneDrive\PhD\research\research-workspace\interactive-auto-mapping-tool\test-systems\ProM\sources\org\processmining\plugins\utils\sequencedistance\GenericLevenshteinDistance.java", "Java", 136, 13, 40, 189
"c:\Users\zipasink\OneDrive\PhD\research\research-workspace\interactive-auto-mapping-tool\test-systems\ProM\sources\org\processmining\plugins\utils\sequencedistance\SequenceDistance.java", "Java", 19, 70, 14, 103
"c:\Users\zipasink\OneDrive\PhD\research\research-workspace\interactive-auto-mapping-tool\test-systems\ProM\sources\org\processmining\saxon\License.java", "Java", 4, 0, 4, 8
"c:\Users\zipasink\OneDrive\PhD\research\research-workspace\interactive-auto-mapping-tool\test-systems\ProM\sources\org\processmining\utils\HTMLUtils.java", "Java", 7, 3, 3, 13
"c:\Users\zipasink\OneDrive\PhD\research\research-workspace\interactive-auto-mapping-tool\test-systems\ProM\sources\org\processmining\widgets\ui\utils\JSplitPaneUtils.java", "Java", 28, 3, 7, 38
"c:\Users\zipasink\OneDrive\PhD\research\research-workspace\interactive-auto-mapping-tool\test-systems\ProM\sources\org\processmining\widgets\wizard\AbstractDialog.java", "Java", 51, 0, 20, 71
"c:\Users\zipasink\OneDrive\PhD\research\research-workspace\interactive-auto-mapping-tool\test-systems\ProM\sources\org\processmining\widgets\wizard\AbstractRoutableDialog.java", "Java", 17, 0, 7, 24
"c:\Users\zipasink\OneDrive\PhD\research\research-workspace\interactive-auto-mapping-tool\test-systems\ProM\sources\org\processmining\widgets\wizard\Dialog.java", "Java", 16, 7, 16, 39
"c:\Users\zipasink\OneDrive\PhD\research\research-workspace\interactive-auto-mapping-tool\test-systems\ProM\sources\org\processmining\widgets\wizard\Route.java", "Java", 4, 0, 4, 8
"c:\Users\zipasink\OneDrive\PhD\research\research-workspace\interactive-auto-mapping-tool\test-systems\ProM\sources\org\processmining\widgets\wizard\Wizard.java", "Java", 35, 0, 7, 42
"c:\Users\zipasink\OneDrive\PhD\research\research-workspace\interactive-auto-mapping-tool\test-systems\ProM\sources\org\processmining\widgets\wizard\WizardResult.java", "Java", 16, 0, 10, 26
"Total", "-", 50983, 13721, 11755, 76459