"filename", "language", "Java", "Markdown", "comment", "blank", "total"
"c:\Users\zipasink\OneDrive\PhD\research\research-workspace\interactive-auto-mapping-tool\test-systems\Jabref\sources\3.7\src\main\java\net\sf\.VSCodeCounter\details.md", "Markdown", 0, 709, 0, 6, 715
"c:\Users\zipasink\OneDrive\PhD\research\research-workspace\interactive-auto-mapping-tool\test-systems\Jabref\sources\3.7\src\main\java\net\sf\.VSCodeCounter\results.md", "Markdown", 0, 177, 0, 7, 184
"c:\Users\zipasink\OneDrive\PhD\research\research-workspace\interactive-auto-mapping-tool\test-systems\Jabref\sources\3.7\src\main\java\net\sf\jabref\Globals.java", "Java", 45, 0, 16, 19, 80
"c:\Users\zipasink\OneDrive\PhD\research\research-workspace\interactive-auto-mapping-tool\test-systems\Jabref\sources\3.7\src\main\java\net\sf\jabref\JabRefException.java", "Java", 33, 0, 0, 12, 45
"c:\Users\zipasink\OneDrive\PhD\research\research-workspace\interactive-auto-mapping-tool\test-systems\Jabref\sources\3.7\src\main\java\net\sf\jabref\JabRefExecutorService.java", "Java", 107, 0, 11, 27, 145
"c:\Users\zipasink\OneDrive\PhD\research\research-workspace\interactive-auto-mapping-tool\test-systems\Jabref\sources\3.7\src\main\java\net\sf\jabref\JabRefGUI.java", "Java", 220, 0, 38, 47, 305
"c:\Users\zipasink\OneDrive\PhD\research\research-workspace\interactive-auto-mapping-tool\test-systems\Jabref\sources\3.7\src\main\java\net\sf\jabref\JabRefMain.java", "Java", 85, 0, 21, 22, 128
"c:\Users\zipasink\OneDrive\PhD\research\research-workspace\interactive-auto-mapping-tool\test-systems\Jabref\sources\3.7\src\main\java\net\sf\jabref\cli\ArgumentProcessor.java", "Java", 479, 0, 47, 81, 607
"c:\Users\zipasink\OneDrive\PhD\research\research-workspace\interactive-auto-mapping-tool\test-systems\Jabref\sources\3.7\src\main\java\net\sf\jabref\cli\AuxCommandLine.java", "Java", 23, 0, 1, 6, 30
"c:\Users\zipasink\OneDrive\PhD\research\research-workspace\interactive-auto-mapping-tool\test-systems\Jabref\sources\3.7\src\main\java\net\sf\jabref\cli\CrossrefFetcherEvaluator.java", "Java", 73, 0, 3, 15, 91
"c:\Users\zipasink\OneDrive\PhD\research\research-workspace\interactive-auto-mapping-tool\test-systems\Jabref\sources\3.7\src\main\java\net\sf\jabref\cli\GenerateCharacterTable.java", "Java", 42, 0, 0, 8, 50
"c:\Users\zipasink\OneDrive\PhD\research\research-workspace\interactive-auto-mapping-tool\test-systems\Jabref\sources\3.7\src\main\java\net\sf\jabref\cli\ImportInspectionCommandLine.java", "Java", 30, 0, 0, 11, 41
"c:\Users\zipasink\OneDrive\PhD\research\research-workspace\interactive-auto-mapping-tool\test-systems\Jabref\sources\3.7\src\main\java\net\sf\jabref\cli\JabRefCLI.java", "Java", 203, 0, 1, 60, 264
"c:\Users\zipasink\OneDrive\PhD\research\research-workspace\interactive-auto-mapping-tool\test-systems\Jabref\sources\3.7\src\main\java\net\sf\jabref\cli\SystemOutputPrinter.java", "Java", 16, 0, 0, 6, 22
"c:\Users\zipasink\OneDrive\PhD\research\research-workspace\interactive-auto-mapping-tool\test-systems\Jabref\sources\3.7\src\main\java\net\sf\jabref\cli\XMPUtilMain.java", "Java", 121, 0, 34, 28, 183
"c:\Users\zipasink\OneDrive\PhD\research\research-workspace\interactive-auto-mapping-tool\test-systems\Jabref\sources\3.7\src\main\java\net\sf\jabref\collab\Change.java", "Java", 35, 0, 18, 15, 68
"c:\Users\zipasink\OneDrive\PhD\research\research-workspace\interactive-auto-mapping-tool\test-systems\Jabref\sources\3.7\src\main\java\net\sf\jabref\collab\ChangeDisplayDialog.java", "Java", 120, 0, 8, 22, 150
"c:\Users\zipasink\OneDrive\PhD\research\research-workspace\interactive-auto-mapping-tool\test-systems\Jabref\sources\3.7\src\main\java\net\sf\jabref\collab\ChangeScanner.java", "Java", 349, 0, 59, 68, 476
"c:\Users\zipasink\OneDrive\PhD\research\research-workspace\interactive-auto-mapping-tool\test-systems\Jabref\sources\3.7\src\main\java\net\sf\jabref\collab\EntryAddChange.java", "Java", 33, 0, 0, 10, 43
"c:\Users\zipasink\OneDrive\PhD\research\research-workspace\interactive-auto-mapping-tool\test-systems\Jabref\sources\3.7\src\main\java\net\sf\jabref\collab\EntryChange.java", "Java", 122, 0, 11, 30, 163
"c:\Users\zipasink\OneDrive\PhD\research\research-workspace\interactive-auto-mapping-tool\test-systems\Jabref\sources\3.7\src\main\java\net\sf\jabref\collab\EntryDeleteChange.java", "Java", 41, 0, 3, 15, 59
"c:\Users\zipasink\OneDrive\PhD\research\research-workspace\interactive-auto-mapping-tool\test-systems\Jabref\sources\3.7\src\main\java\net\sf\jabref\collab\FileUpdateListener.java", "Java", 5, 0, 6, 5, 16
"c:\Users\zipasink\OneDrive\PhD\research\research-workspace\interactive-auto-mapping-tool\test-systems\Jabref\sources\3.7\src\main\java\net\sf\jabref\collab\FileUpdateMonitor.java", "Java", 144, 0, 50, 31, 225
"c:\Users\zipasink\OneDrive\PhD\research\research-workspace\interactive-auto-mapping-tool\test-systems\Jabref\sources\3.7\src\main\java\net\sf\jabref\collab\FileUpdatePanel.java", "Java", 63, 0, 27, 21, 111
"c:\Users\zipasink\OneDrive\PhD\research\research-workspace\interactive-auto-mapping-tool\test-systems\Jabref\sources\3.7\src\main\java\net\sf\jabref\collab\GroupChange.java", "Java", 56, 0, 6, 12, 74
"c:\Users\zipasink\OneDrive\PhD\research\research-workspace\interactive-auto-mapping-tool\test-systems\Jabref\sources\3.7\src\main\java\net\sf\jabref\collab\InfoPane.java", "Java", 18, 0, 0, 6, 24
"c:\Users\zipasink\OneDrive\PhD\research\research-workspace\interactive-auto-mapping-tool\test-systems\Jabref\sources\3.7\src\main\java\net\sf\jabref\collab\MetaDataChange.java", "Java", 29, 0, 12, 9, 50
"c:\Users\zipasink\OneDrive\PhD\research\research-workspace\interactive-auto-mapping-tool\test-systems\Jabref\sources\3.7\src\main\java\net\sf\jabref\collab\PreambleChange.java", "Java", 41, 0, 0, 13, 54
"c:\Users\zipasink\OneDrive\PhD\research\research-workspace\interactive-auto-mapping-tool\test-systems\Jabref\sources\3.7\src\main\java\net\sf\jabref\collab\StringAddChange.java", "Java", 50, 0, 1, 15, 66
"c:\Users\zipasink\OneDrive\PhD\research\research-workspace\interactive-auto-mapping-tool\test-systems\Jabref\sources\3.7\src\main\java\net\sf\jabref\collab\StringChange.java", "Java", 74, 0, 2, 16, 92
"c:\Users\zipasink\OneDrive\PhD\research\research-workspace\interactive-auto-mapping-tool\test-systems\Jabref\sources\3.7\src\main\java\net\sf\jabref\collab\StringNameChange.java", "Java", 63, 0, 3, 17, 83
"c:\Users\zipasink\OneDrive\PhD\research\research-workspace\interactive-auto-mapping-tool\test-systems\Jabref\sources\3.7\src\main\java\net\sf\jabref\collab\StringRemoveChange.java", "Java", 43, 0, 1, 16, 60
"c:\Users\zipasink\OneDrive\PhD\research\research-workspace\interactive-auto-mapping-tool\test-systems\Jabref\sources\3.7\src\main\java\net\sf\jabref\gui\BasePanel.java", "Java", 1762, 0, 302, 347, 2411
"c:\Users\zipasink\OneDrive\PhD\research\research-workspace\interactive-auto-mapping-tool\test-systems\Jabref\sources\3.7\src\main\java\net\sf\jabref\gui\BasePanelMode.java", "Java", 7, 0, 3, 3, 13
"c:\Users\zipasink\OneDrive\PhD\research\research-workspace\interactive-auto-mapping-tool\test-systems\Jabref\sources\3.7\src\main\java\net\sf\jabref\gui\ClipBoardManager.java", "Java", 83, 0, 20, 14, 117
"c:\Users\zipasink\OneDrive\PhD\research\research-workspace\interactive-auto-mapping-tool\test-systems\Jabref\sources\3.7\src\main\java\net\sf\jabref\gui\DragDropPane.java", "Java", 116, 0, 20, 23, 159
"c:\Users\zipasink\OneDrive\PhD\research\research-workspace\interactive-auto-mapping-tool\test-systems\Jabref\sources\3.7\src\main\java\net\sf\jabref\gui\DragDropPopupPane.java", "Java", 20, 0, 4, 8, 32
"c:\Users\zipasink\OneDrive\PhD\research\research-workspace\interactive-auto-mapping-tool\test-systems\Jabref\sources\3.7\src\main\java\net\sf\jabref\gui\DuplicateResolverDialog.java", "Java", 128, 0, 0, 22, 150
"c:\Users\zipasink\OneDrive\PhD\research\research-workspace\interactive-auto-mapping-tool\test-systems\Jabref\sources\3.7\src\main\java\net\sf\jabref\gui\DuplicateSearch.java", "Java", 169, 0, 10, 43, 222
"c:\Users\zipasink\OneDrive\PhD\research\research-workspace\interactive-auto-mapping-tool\test-systems\Jabref\sources\3.7\src\main\java\net\sf\jabref\gui\EntryContainer.java", "Java", 6, 0, 3, 4, 13
"c:\Users\zipasink\OneDrive\PhD\research\research-workspace\interactive-auto-mapping-tool\test-systems\Jabref\sources\3.7\src\main\java\net\sf\jabref\gui\EntryCustomizationDialog.java", "Java", 375, 0, 27, 59, 461
"c:\Users\zipasink\OneDrive\PhD\research\research-workspace\interactive-auto-mapping-tool\test-systems\Jabref\sources\3.7\src\main\java\net\sf\jabref\gui\EntryMarker.java", "Java", 149, 0, 33, 16, 198
"c:\Users\zipasink\OneDrive\PhD\research\research-workspace\interactive-auto-mapping-tool\test-systems\Jabref\sources\3.7\src\main\java\net\sf\jabref\gui\EntryTypeDialog.java", "Java", 263, 0, 8, 60, 331
"c:\Users\zipasink\OneDrive\PhD\research\research-workspace\interactive-auto-mapping-tool\test-systems\Jabref\sources\3.7\src\main\java\net\sf\jabref\gui\EntryTypeList.java", "Java", 110, 0, 16, 19, 145
"c:\Users\zipasink\OneDrive\PhD\research\research-workspace\interactive-auto-mapping-tool\test-systems\Jabref\sources\3.7\src\main\java\net\sf\jabref\gui\FieldSetComponent.java", "Java", 285, 0, 50, 47, 382
"c:\Users\zipasink\OneDrive\PhD\research\research-workspace\interactive-auto-mapping-tool\test-systems\Jabref\sources\3.7\src\main\java\net\sf\jabref\gui\FileDialog.java", "Java", 131, 0, 63, 30, 224
"c:\Users\zipasink\OneDrive\PhD\research\research-workspace\interactive-auto-mapping-tool\test-systems\Jabref\sources\3.7\src\main\java\net\sf\jabref\gui\FindUnlinkedFilesDialog.java", "Java", 764, 0, 236, 179, 1179
"c:\Users\zipasink\OneDrive\PhD\research\research-workspace\interactive-auto-mapping-tool\test-systems\Jabref\sources\3.7\src\main\java\net\sf\jabref\gui\GUIGlobals.java", "Java", 112, 0, 14, 34, 160
"c:\Users\zipasink\OneDrive\PhD\research\research-workspace\interactive-auto-mapping-tool\test-systems\Jabref\sources\3.7\src\main\java\net\sf\jabref\gui\GenFieldsCustomizer.java", "Java", 149, 0, 3, 24, 176
"c:\Users\zipasink\OneDrive\PhD\research\research-workspace\interactive-auto-mapping-tool\test-systems\Jabref\sources\3.7\src\main\java\net\sf\jabref\gui\GlobalFocusListener.java", "Java", 23, 0, 1, 8, 32
"c:\Users\zipasink\OneDrive\PhD\research\research-workspace\interactive-auto-mapping-tool\test-systems\Jabref\sources\3.7\src\main\java\net\sf\jabref\gui\IconTheme.java", "Java", 239, 0, 31, 45, 315
"c:\Users\zipasink\OneDrive\PhD\research\research-workspace\interactive-auto-mapping-tool\test-systems\Jabref\sources\3.7\src\main\java\net\sf\jabref\gui\JEditorPaneWithHighlighting.java", "Java", 45, 0, 1, 13, 59
"c:\Users\zipasink\OneDrive\PhD\research\research-workspace\interactive-auto-mapping-tool\test-systems\Jabref\sources\3.7\src\main\java\net\sf\jabref\gui\JabRefFrame.java", "Java", 1853, 0, 220, 344, 2417
"c:\Users\zipasink\OneDrive\PhD\research\research-workspace\interactive-auto-mapping-tool\test-systems\Jabref\sources\3.7\src\main\java\net\sf\jabref\gui\MergeDialog.java", "Java", 87, 0, 7, 18, 112
"c:\Users\zipasink\OneDrive\PhD\research\research-workspace\interactive-auto-mapping-tool\test-systems\Jabref\sources\3.7\src\main\java\net\sf\jabref\gui\OSXCompatibleToolbar.java", "Java", 28, 0, 0, 12, 40
"c:\Users\zipasink\OneDrive\PhD\research\research-workspace\interactive-auto-mapping-tool\test-systems\Jabref\sources\3.7\src\main\java\net\sf\jabref\gui\PreambleEditor.java", "Java", 162, 0, 9, 54, 225
"c:\Users\zipasink\OneDrive\PhD\research\research-workspace\interactive-auto-mapping-tool\test-systems\Jabref\sources\3.7\src\main\java\net\sf\jabref\gui\PreviewPanel.java", "Java", 293, 0, 40, 73, 406
"c:\Users\zipasink\OneDrive\PhD\research\research-workspace\interactive-auto-mapping-tool\test-systems\Jabref\sources\3.7\src\main\java\net\sf\jabref\gui\ReplaceStringDialog.java", "Java", 190, 0, 12, 27, 229
"c:\Users\zipasink\OneDrive\PhD\research\research-workspace\interactive-auto-mapping-tool\test-systems\Jabref\sources\3.7\src\main\java\net\sf\jabref\gui\SaveOrderConfigDisplay.java", "Java", 87, 0, 0, 23, 110
"c:\Users\zipasink\OneDrive\PhD\research\research-workspace\interactive-auto-mapping-tool\test-systems\Jabref\sources\3.7\src\main\java\net\sf\jabref\gui\SidePane.java", "Java", 62, 0, 13, 20, 95
"c:\Users\zipasink\OneDrive\PhD\research\research-workspace\interactive-auto-mapping-tool\test-systems\Jabref\sources\3.7\src\main\java\net\sf\jabref\gui\SidePaneComponent.java", "Java", 104, 0, 16, 38, 158
"c:\Users\zipasink\OneDrive\PhD\research\research-workspace\interactive-auto-mapping-tool\test-systems\Jabref\sources\3.7\src\main\java\net\sf\jabref\gui\SidePaneManager.java", "Java", 212, 0, 30, 48, 290
"c:\Users\zipasink\OneDrive\PhD\research\research-workspace\interactive-auto-mapping-tool\test-systems\Jabref\sources\3.7\src\main\java\net\sf\jabref\gui\StringDialog.java", "Java", 367, 0, 16, 88, 471
"c:\Users\zipasink\OneDrive\PhD\research\research-workspace\interactive-auto-mapping-tool\test-systems\Jabref\sources\3.7\src\main\java\net\sf\jabref\gui\TransferableBibtexEntry.java", "Java", 54, 0, 4, 11, 69
"c:\Users\zipasink\OneDrive\PhD\research\research-workspace\interactive-auto-mapping-tool\test-systems\Jabref\sources\3.7\src\main\java\net\sf\jabref\gui\WaitForSaveOperation.java", "Java", 63, 0, 3, 17, 83
"c:\Users\zipasink\OneDrive\PhD\research\research-workspace\interactive-auto-mapping-tool\test-systems\Jabref\sources\3.7\src\main\java\net\sf\jabref\gui\WrapLayout.java", "Java", 79, 0, 66, 30, 175
"c:\Users\zipasink\OneDrive\PhD\research\research-workspace\interactive-auto-mapping-tool\test-systems\Jabref\sources\3.7\src\main\java\net\sf\jabref\gui\actions\Actions.java", "Java", 64, 0, 3, 3, 70
"c:\Users\zipasink\OneDrive\PhD\research\research-workspace\interactive-auto-mapping-tool\test-systems\Jabref\sources\3.7\src\main\java\net\sf\jabref\gui\actions\AutoLinkFilesAction.java", "Java", 49, 0, 5, 7, 61
"c:\Users\zipasink\OneDrive\PhD\research\research-workspace\interactive-auto-mapping-tool\test-systems\Jabref\sources\3.7\src\main\java\net\sf\jabref\gui\actions\BaseAction.java", "Java", 5, 0, 5, 3, 13
"c:\Users\zipasink\OneDrive\PhD\research\research-workspace\interactive-auto-mapping-tool\test-systems\Jabref\sources\3.7\src\main\java\net\sf\jabref\gui\actions\ChangeTypeAction.java", "Java", 18, 0, 0, 8, 26
"c:\Users\zipasink\OneDrive\PhD\research\research-workspace\interactive-auto-mapping-tool\test-systems\Jabref\sources\3.7\src\main\java\net\sf\jabref\gui\actions\CleanupAction.java", "Java", 131, 0, 9, 24, 164
"c:\Users\zipasink\OneDrive\PhD\research\research-workspace\interactive-auto-mapping-tool\test-systems\Jabref\sources\3.7\src\main\java\net\sf\jabref\gui\actions\ConnectToSharedDatabaseAction.java", "Java", 20, 0, 3, 9, 32
"c:\Users\zipasink\OneDrive\PhD\research\research-workspace\interactive-auto-mapping-tool\test-systems\Jabref\sources\3.7\src\main\java\net\sf\jabref\gui\actions\CopyAction.java", "Java", 31, 0, 0, 8, 39
"c:\Users\zipasink\OneDrive\PhD\research\research-workspace\interactive-auto-mapping-tool\test-systems\Jabref\sources\3.7\src\main\java\net\sf\jabref\gui\actions\CopyBibTeXKeyAndLinkAction.java", "Java", 44, 0, 6, 12, 62
"c:\Users\zipasink\OneDrive\PhD\research\research-workspace\interactive-auto-mapping-tool\test-systems\Jabref\sources\3.7\src\main\java\net\sf\jabref\gui\actions\CopyDoiUrlAction.java", "Java", 33, 0, 3, 10, 46
"c:\Users\zipasink\OneDrive\PhD\research\research-workspace\interactive-auto-mapping-tool\test-systems\Jabref\sources\3.7\src\main\java\net\sf\jabref\gui\actions\CopyVersionToClipboardAction.java", "Java", 17, 0, 0, 7, 24
"c:\Users\zipasink\OneDrive\PhD\research\research-workspace\interactive-auto-mapping-tool\test-systems\Jabref\sources\3.7\src\main\java\net\sf\jabref\gui\actions\ErrorConsoleAction.java", "Java", 51, 0, 16, 14, 81
"c:\Users\zipasink\OneDrive\PhD\research\research-workspace\interactive-auto-mapping-tool\test-systems\Jabref\sources\3.7\src\main\java\net\sf\jabref\gui\actions\IntegrityCheckAction.java", "Java", 107, 0, 4, 24, 135
"c:\Users\zipasink\OneDrive\PhD\research\research-workspace\interactive-auto-mapping-tool\test-systems\Jabref\sources\3.7\src\main\java\net\sf\jabref\gui\actions\ManageKeywordsAction.java", "Java", 267, 0, 22, 65, 354
"c:\Users\zipasink\OneDrive\PhD\research\research-workspace\interactive-auto-mapping-tool\test-systems\Jabref\sources\3.7\src\main\java\net\sf\jabref\gui\actions\MassSetFieldAction.java", "Java", 244, 0, 43, 34, 321
"c:\Users\zipasink\OneDrive\PhD\research\research-workspace\interactive-auto-mapping-tool\test-systems\Jabref\sources\3.7\src\main\java\net\sf\jabref\gui\actions\MnemonicAwareAction.java", "Java", 31, 0, 7, 7, 45
"c:\Users\zipasink\OneDrive\PhD\research\research-workspace\interactive-auto-mapping-tool\test-systems\Jabref\sources\3.7\src\main\java\net\sf\jabref\gui\actions\NewDatabaseAction.java", "Java", 27, 0, 4, 8, 39
"c:\Users\zipasink\OneDrive\PhD\research\research-workspace\interactive-auto-mapping-tool\test-systems\Jabref\sources\3.7\src\main\java\net\sf\jabref\gui\actions\NewEntryAction.java", "Java", 57, 0, 3, 12, 72
"c:\Users\zipasink\OneDrive\PhD\research\research-workspace\interactive-auto-mapping-tool\test-systems\Jabref\sources\3.7\src\main\java\net\sf\jabref\gui\actions\NewSubDatabaseAction.java", "Java", 35, 0, 4, 11, 50
"c:\Users\zipasink\OneDrive\PhD\research\research-workspace\interactive-auto-mapping-tool\test-systems\Jabref\sources\3.7\src\main\java\net\sf\jabref\gui\actions\OpenBrowserAction.java", "Java", 24, 0, 16, 10, 50
"c:\Users\zipasink\OneDrive\PhD\research\research-workspace\interactive-auto-mapping-tool\test-systems\Jabref\sources\3.7\src\main\java\net\sf\jabref\gui\actions\PasteAction.java", "Java", 32, 0, 4, 9, 45
"c:\Users\zipasink\OneDrive\PhD\research\research-workspace\interactive-auto-mapping-tool\test-systems\Jabref\sources\3.7\src\main\java\net\sf\jabref\gui\actions\SearchForUpdateAction.java", "Java", 14, 0, 0, 7, 21
"c:\Users\zipasink\OneDrive\PhD\research\research-workspace\interactive-auto-mapping-tool\test-systems\Jabref\sources\3.7\src\main\java\net\sf\jabref\gui\actions\SortTabsAction.java", "Java", 32, 0, 5, 10, 47
"c:\Users\zipasink\OneDrive\PhD\research\research-workspace\interactive-auto-mapping-tool\test-systems\Jabref\sources\3.7\src\main\java\net\sf\jabref\gui\autocompleter\AutoCompleteListener.java", "Java", 312, 0, 105, 66, 483
"c:\Users\zipasink\OneDrive\PhD\research\research-workspace\interactive-auto-mapping-tool\test-systems\Jabref\sources\3.7\src\main\java\net\sf\jabref\gui\autocompleter\AutoCompleteRenderer.java", "Java", 15, 0, 37, 8, 60
"c:\Users\zipasink\OneDrive\PhD\research\research-workspace\interactive-auto-mapping-tool\test-systems\Jabref\sources\3.7\src\main\java\net\sf\jabref\gui\autocompleter\AutoCompleteSupport.java", "Java", 161, 0, 80, 51, 292
"c:\Users\zipasink\OneDrive\PhD\research\research-workspace\interactive-auto-mapping-tool\test-systems\Jabref\sources\3.7\src\main\java\net\sf\jabref\gui\autocompleter\ListAutoCompleteRenderer.java", "Java", 64, 0, 12, 13, 89
"c:\Users\zipasink\OneDrive\PhD\research\research-workspace\interactive-auto-mapping-tool\test-systems\Jabref\sources\3.7\src\main\java\net\sf\jabref\gui\autosaveandbackup\AutosaveUIManager.java", "Java", 22, 0, 4, 8, 34
"c:\Users\zipasink\OneDrive\PhD\research\research-workspace\interactive-auto-mapping-tool\test-systems\Jabref\sources\3.7\src\main\java\net\sf\jabref\gui\autosaveandbackup\BackupUIManager.java", "Java", 21, 0, 3, 7, 31
"c:\Users\zipasink\OneDrive\PhD\research\research-workspace\interactive-auto-mapping-tool\test-systems\Jabref\sources\3.7\src\main\java\net\sf\jabref\gui\auximport\FromAuxDialog.java", "Java", 179, 0, 8, 42, 229
"c:\Users\zipasink\OneDrive\PhD\research\research-workspace\interactive-auto-mapping-tool\test-systems\Jabref\sources\3.7\src\main\java\net\sf\jabref\gui\bibtexkeypattern\BibtexKeyPatternDialog.java", "Java", 75, 0, 5, 22, 102
"c:\Users\zipasink\OneDrive\PhD\research\research-workspace\interactive-auto-mapping-tool\test-systems\Jabref\sources\3.7\src\main\java\net\sf\jabref\gui\bibtexkeypattern\BibtexKeyPatternPanel.java", "Java", 210, 0, 21, 34, 265
"c:\Users\zipasink\OneDrive\PhD\research\research-workspace\interactive-auto-mapping-tool\test-systems\Jabref\sources\3.7\src\main\java\net\sf\jabref\gui\bibtexkeypattern\ResolveDuplicateLabelDialog.java", "Java", 95, 0, 13, 24, 132
"c:\Users\zipasink\OneDrive\PhD\research\research-workspace\interactive-auto-mapping-tool\test-systems\Jabref\sources\3.7\src\main\java\net\sf\jabref\gui\bibtexkeypattern\SearchFixDuplicateLabels.java", "Java", 82, 0, 13, 15, 110
"c:\Users\zipasink\OneDrive\PhD\research\research-workspace\interactive-auto-mapping-tool\test-systems\Jabref\sources\3.7\src\main\java\net\sf\jabref\gui\cleanup\CleanupActionsListModel.java", "Java", 59, 0, 5, 18, 82
"c:\Users\zipasink\OneDrive\PhD\research\research-workspace\interactive-auto-mapping-tool\test-systems\Jabref\sources\3.7\src\main\java\net\sf\jabref\gui\cleanup\CleanupPresetPanel.java", "Java", 125, 0, 0, 26, 151
"c:\Users\zipasink\OneDrive\PhD\research\research-workspace\interactive-auto-mapping-tool\test-systems\Jabref\sources\3.7\src\main\java\net\sf\jabref\gui\cleanup\FieldFormatterCleanupsPanel.java", "Java", 246, 0, 15, 69, 330
"c:\Users\zipasink\OneDrive\PhD\research\research-workspace\interactive-auto-mapping-tool\test-systems\Jabref\sources\3.7\src\main\java\net\sf\jabref\gui\date\DatePickerButton.java", "Java", 46, 0, 6, 11, 63
"c:\Users\zipasink\OneDrive\PhD\research\research-workspace\interactive-auto-mapping-tool\test-systems\Jabref\sources\3.7\src\main\java\net\sf\jabref\gui\dbproperties\DatabasePropertiesDialog.java", "Java", 253, 0, 7, 50, 310
"c:\Users\zipasink\OneDrive\PhD\research\research-workspace\interactive-auto-mapping-tool\test-systems\Jabref\sources\3.7\src\main\java\net\sf\jabref\gui\desktop\JabRefDesktop.java", "Java", 252, 0, 66, 36, 354
"c:\Users\zipasink\OneDrive\PhD\research\research-workspace\interactive-auto-mapping-tool\test-systems\Jabref\sources\3.7\src\main\java\net\sf\jabref\gui\desktop\os\DefaultDesktop.java", "Java", 31, 0, 0, 9, 40
"c:\Users\zipasink\OneDrive\PhD\research\research-workspace\interactive-auto-mapping-tool\test-systems\Jabref\sources\3.7\src\main\java\net\sf\jabref\gui\desktop\os\Linux.java", "Java", 72, 0, 1, 16, 89
"c:\Users\zipasink\OneDrive\PhD\research\research-workspace\interactive-auto-mapping-tool\test-systems\Jabref\sources\3.7\src\main\java\net\sf\jabref\gui\desktop\os\NativeDesktop.java", "Java", 9, 0, 7, 7, 23
"c:\Users\zipasink\OneDrive\PhD\research\research-workspace\interactive-auto-mapping-tool\test-systems\Jabref\sources\3.7\src\main\java\net\sf\jabref\gui\desktop\os\OSX.java", "Java", 38, 0, 1, 9, 48
"c:\Users\zipasink\OneDrive\PhD\research\research-workspace\interactive-auto-mapping-tool\test-systems\Jabref\sources\3.7\src\main\java\net\sf\jabref\gui\desktop\os\Windows.java", "Java", 45, 0, 1, 10, 56
"c:\Users\zipasink\OneDrive\PhD\research\research-workspace\interactive-auto-mapping-tool\test-systems\Jabref\sources\3.7\src\main\java\net\sf\jabref\gui\entryeditor\EntryEditor.java", "Java", 1042, 0, 133, 234, 1409
"c:\Users\zipasink\OneDrive\PhD\research\research-workspace\interactive-auto-mapping-tool\test-systems\Jabref\sources\3.7\src\main\java\net\sf\jabref\gui\entryeditor\EntryEditorTab.java", "Java", 309, 0, 40, 69, 418
"c:\Users\zipasink\OneDrive\PhD\research\research-workspace\interactive-auto-mapping-tool\test-systems\Jabref\sources\3.7\src\main\java\net\sf\jabref\gui\entryeditor\EntryEditorTabFocusListener.java", "Java", 76, 0, 7, 21, 104
"c:\Users\zipasink\OneDrive\PhD\research\research-workspace\interactive-auto-mapping-tool\test-systems\Jabref\sources\3.7\src\main\java\net\sf\jabref\gui\entryeditor\EntryEditorTabList.java", "Java", 47, 0, 5, 10, 62
"c:\Users\zipasink\OneDrive\PhD\research\research-workspace\interactive-auto-mapping-tool\test-systems\Jabref\sources\3.7\src\main\java\net\sf\jabref\gui\entryeditor\FieldExtraComponents.java", "Java", 350, 0, 106, 64, 520
"c:\Users\zipasink\OneDrive\PhD\research\research-workspace\interactive-auto-mapping-tool\test-systems\Jabref\sources\3.7\src\main\java\net\sf\jabref\gui\exporter\CustomExportDialog.java", "Java", 163, 0, 8, 32, 203
"c:\Users\zipasink\OneDrive\PhD\research\research-workspace\interactive-auto-mapping-tool\test-systems\Jabref\sources\3.7\src\main\java\net\sf\jabref\gui\exporter\ExportAction.java", "Java", 144, 0, 23, 27, 194
"c:\Users\zipasink\OneDrive\PhD\research\research-workspace\interactive-auto-mapping-tool\test-systems\Jabref\sources\3.7\src\main\java\net\sf\jabref\gui\exporter\ExportCustomizationDialog.java", "Java", 157, 0, 10, 25, 192
"c:\Users\zipasink\OneDrive\PhD\research\research-workspace\interactive-auto-mapping-tool\test-systems\Jabref\sources\3.7\src\main\java\net\sf\jabref\gui\exporter\ExportFileFilter.java", "Java", 51, 0, 4, 16, 71
"c:\Users\zipasink\OneDrive\PhD\research\research-workspace\interactive-auto-mapping-tool\test-systems\Jabref\sources\3.7\src\main\java\net\sf\jabref\gui\exporter\ExportToClipboardAction.java", "Java", 103, 0, 19, 21, 143
"c:\Users\zipasink\OneDrive\PhD\research\research-workspace\interactive-auto-mapping-tool\test-systems\Jabref\sources\3.7\src\main\java\net\sf\jabref\gui\exporter\RtfSelection.java", "Java", 43, 0, 0, 12, 55
"c:\Users\zipasink\OneDrive\PhD\research\research-workspace\interactive-auto-mapping-tool\test-systems\Jabref\sources\3.7\src\main\java\net\sf\jabref\gui\exporter\SaveAllAction.java", "Java", 44, 0, 6, 12, 62
"c:\Users\zipasink\OneDrive\PhD\research\research-workspace\interactive-auto-mapping-tool\test-systems\Jabref\sources\3.7\src\main\java\net\sf\jabref\gui\exporter\SaveDatabaseAction.java", "Java", 328, 0, 77, 57, 462
"c:\Users\zipasink\OneDrive\PhD\research\research-workspace\interactive-auto-mapping-tool\test-systems\Jabref\sources\3.7\src\main\java\net\sf\jabref\gui\externalfiles\AutoSetLinks.java", "Java", 152, 0, 59, 18, 229
"c:\Users\zipasink\OneDrive\PhD\research\research-workspace\interactive-auto-mapping-tool\test-systems\Jabref\sources\3.7\src\main\java\net\sf\jabref\gui\externalfiles\DownloadExternalFile.java", "Java", 238, 0, 78, 33, 349
"c:\Users\zipasink\OneDrive\PhD\research\research-workspace\interactive-auto-mapping-tool\test-systems\Jabref\sources\3.7\src\main\java\net\sf\jabref\gui\externalfiles\DroppedFileHandler.java", "Java", 390, 0, 91, 82, 563
"c:\Users\zipasink\OneDrive\PhD\research\research-workspace\interactive-auto-mapping-tool\test-systems\Jabref\sources\3.7\src\main\java\net\sf\jabref\gui\externalfiles\FindFullTextAction.java", "Java", 103, 0, 3, 13, 119
"c:\Users\zipasink\OneDrive\PhD\research\research-workspace\interactive-auto-mapping-tool\test-systems\Jabref\sources\3.7\src\main\java\net\sf\jabref\gui\externalfiles\MoveFileAction.java", "Java", 157, 0, 14, 26, 197
"c:\Users\zipasink\OneDrive\PhD\research\research-workspace\interactive-auto-mapping-tool\test-systems\Jabref\sources\3.7\src\main\java\net\sf\jabref\gui\externalfiles\SynchronizeFileField.java", "Java", 322, 0, 27, 53, 402
"c:\Users\zipasink\OneDrive\PhD\research\research-workspace\interactive-auto-mapping-tool\test-systems\Jabref\sources\3.7\src\main\java\net\sf\jabref\gui\externalfiles\TransferableFileLinkSelection.java", "Java", 45, 0, 50, 13, 108
"c:\Users\zipasink\OneDrive\PhD\research\research-workspace\interactive-auto-mapping-tool\test-systems\Jabref\sources\3.7\src\main\java\net\sf\jabref\gui\externalfiles\WriteXMPAction.java", "Java", 226, 0, 10, 62, 298
"c:\Users\zipasink\OneDrive\PhD\research\research-workspace\interactive-auto-mapping-tool\test-systems\Jabref\sources\3.7\src\main\java\net\sf\jabref\gui\externalfiles\WriteXMPEntryEditorAction.java", "Java", 109, 0, 13, 22, 144
"c:\Users\zipasink\OneDrive\PhD\research\research-workspace\interactive-auto-mapping-tool\test-systems\Jabref\sources\3.7\src\main\java\net\sf\jabref\gui\externalfiletype\ExternalFileMenuItem.java", "Java", 84, 0, 12, 17, 113
"c:\Users\zipasink\OneDrive\PhD\research\research-workspace\interactive-auto-mapping-tool\test-systems\Jabref\sources\3.7\src\main\java\net\sf\jabref\gui\externalfiletype\ExternalFileType.java", "Java", 136, 0, 53, 34, 223
"c:\Users\zipasink\OneDrive\PhD\research\research-workspace\interactive-auto-mapping-tool\test-systems\Jabref\sources\3.7\src\main\java\net\sf\jabref\gui\externalfiletype\ExternalFileTypeEditor.java", "Java", 299, 0, 32, 55, 386
"c:\Users\zipasink\OneDrive\PhD\research\research-workspace\interactive-auto-mapping-tool\test-systems\Jabref\sources\3.7\src\main\java\net\sf\jabref\gui\externalfiletype\ExternalFileTypeEntryEditor.java", "Java", 206, 0, 6, 38, 250
"c:\Users\zipasink\OneDrive\PhD\research\research-workspace\interactive-auto-mapping-tool\test-systems\Jabref\sources\3.7\src\main\java\net\sf\jabref\gui\externalfiletype\ExternalFileTypes.java", "Java", 220, 0, 73, 30, 323
"c:\Users\zipasink\OneDrive\PhD\research\research-workspace\interactive-auto-mapping-tool\test-systems\Jabref\sources\3.7\src\main\java\net\sf\jabref\gui\externalfiletype\UnknownExternalFileType.java", "Java", 7, 0, 5, 5, 17
"c:\Users\zipasink\OneDrive\PhD\research\research-workspace\interactive-auto-mapping-tool\test-systems\Jabref\sources\3.7\src\main\java\net\sf\jabref\gui\fieldeditors\EntryLinkListEditor.java", "Java", 436, 0, 31, 85, 552
"c:\Users\zipasink\OneDrive\PhD\research\research-workspace\interactive-auto-mapping-tool\test-systems\Jabref\sources\3.7\src\main\java\net\sf\jabref\gui\fieldeditors\FieldEditor.java", "Java", 31, 0, 25, 28, 84
"c:\Users\zipasink\OneDrive\PhD\research\research-workspace\interactive-auto-mapping-tool\test-systems\Jabref\sources\3.7\src\main\java\net\sf\jabref\gui\fieldeditors\FieldEditorFocusListener.java", "Java", 21, 0, 3, 6, 30
"c:\Users\zipasink\OneDrive\PhD\research\research-workspace\interactive-auto-mapping-tool\test-systems\Jabref\sources\3.7\src\main\java\net\sf\jabref\gui\fieldeditors\FieldNameLabel.java", "Java", 29, 0, 0, 11, 40
"c:\Users\zipasink\OneDrive\PhD\research\research-workspace\interactive-auto-mapping-tool\test-systems\Jabref\sources\3.7\src\main\java\net\sf\jabref\gui\fieldeditors\FileListEditor.java", "Java", 449, 0, 46, 68, 563
"c:\Users\zipasink\OneDrive\PhD\research\research-workspace\interactive-auto-mapping-tool\test-systems\Jabref\sources\3.7\src\main\java\net\sf\jabref\gui\fieldeditors\FileListEditorTransferHandler.java", "Java", 107, 0, 25, 24, 156
"c:\Users\zipasink\OneDrive\PhD\research\research-workspace\interactive-auto-mapping-tool\test-systems\Jabref\sources\3.7\src\main\java\net\sf\jabref\gui\fieldeditors\HtmlTransferable.java", "Java", 40, 0, 7, 12, 59
"c:\Users\zipasink\OneDrive\PhD\research\research-workspace\interactive-auto-mapping-tool\test-systems\Jabref\sources\3.7\src\main\java\net\sf\jabref\gui\fieldeditors\JTextAreaWithHighlighting.java", "Java", 121, 0, 28, 28, 177
"c:\Users\zipasink\OneDrive\PhD\research\research-workspace\interactive-auto-mapping-tool\test-systems\Jabref\sources\3.7\src\main\java\net\sf\jabref\gui\fieldeditors\PreviewPanelTransferHandler.java", "Java", 40, 0, 11, 13, 64
"c:\Users\zipasink\OneDrive\PhD\research\research-workspace\interactive-auto-mapping-tool\test-systems\Jabref\sources\3.7\src\main\java\net\sf\jabref\gui\fieldeditors\TextArea.java", "Java", 121, 0, 8, 39, 168
"c:\Users\zipasink\OneDrive\PhD\research\research-workspace\interactive-auto-mapping-tool\test-systems\Jabref\sources\3.7\src\main\java\net\sf\jabref\gui\fieldeditors\TextField.java", "Java", 164, 0, 19, 45, 228
"c:\Users\zipasink\OneDrive\PhD\research\research-workspace\interactive-auto-mapping-tool\test-systems\Jabref\sources\3.7\src\main\java\net\sf\jabref\gui\fieldeditors\contextmenu\CaseChangeMenu.java", "Java", 20, 0, 1, 7, 28
"c:\Users\zipasink\OneDrive\PhD\research\research-workspace\interactive-auto-mapping-tool\test-systems\Jabref\sources\3.7\src\main\java\net\sf\jabref\gui\fieldeditors\contextmenu\ConversionMenu.java", "Java", 18, 0, 6, 5, 29
"c:\Users\zipasink\OneDrive\PhD\research\research-workspace\interactive-auto-mapping-tool\test-systems\Jabref\sources\3.7\src\main\java\net\sf\jabref\gui\fieldeditors\contextmenu\FieldTextMenu.java", "Java", 113, 0, 4, 24, 141
"c:\Users\zipasink\OneDrive\PhD\research\research-workspace\interactive-auto-mapping-tool\test-systems\Jabref\sources\3.7\src\main\java\net\sf\jabref\gui\fieldeditors\contextmenu\ProtectedTermsMenu.java", "Java", 59, 0, 1, 14, 74
"c:\Users\zipasink\OneDrive\PhD\research\research-workspace\interactive-auto-mapping-tool\test-systems\Jabref\sources\3.7\src\main\java\net\sf\jabref\gui\filelist\AttachFileAction.java", "Java", 36, 0, 7, 9, 52
"c:\Users\zipasink\OneDrive\PhD\research\research-workspace\interactive-auto-mapping-tool\test-systems\Jabref\sources\3.7\src\main\java\net\sf\jabref\gui\filelist\ConfirmCloseFileListEntryEditor.java", "Java", 5, 0, 5, 3, 13
"c:\Users\zipasink\OneDrive\PhD\research\research-workspace\interactive-auto-mapping-tool\test-systems\Jabref\sources\3.7\src\main\java\net\sf\jabref\gui\filelist\FileListEntry.java", "Java", 32, 0, 3, 11, 46
"c:\Users\zipasink\OneDrive\PhD\research\research-workspace\interactive-auto-mapping-tool\test-systems\Jabref\sources\3.7\src\main\java\net\sf\jabref\gui\filelist\FileListEntryEditor.java", "Java", 285, 0, 26, 54, 365
"c:\Users\zipasink\OneDrive\PhD\research\research-workspace\interactive-auto-mapping-tool\test-systems\Jabref\sources\3.7\src\main\java\net\sf\jabref\gui\filelist\FileListTableModel.java", "Java", 151, 0, 38, 34, 223
"c:\Users\zipasink\OneDrive\PhD\research\research-workspace\interactive-auto-mapping-tool\test-systems\Jabref\sources\3.7\src\main\java\net\sf\jabref\gui\groups\AddToGroupAction.java", "Java", 81, 0, 7, 23, 111
"c:\Users\zipasink\OneDrive\PhD\research\research-workspace\interactive-auto-mapping-tool\test-systems\Jabref\sources\3.7\src\main\java\net\sf\jabref\gui\groups\AutoGroupDialog.java", "Java", 166, 0, 7, 23, 196
"c:\Users\zipasink\OneDrive\PhD\research\research-workspace\interactive-auto-mapping-tool\test-systems\Jabref\sources\3.7\src\main\java\net\sf\jabref\gui\groups\EntryTableTransferHandler.java", "Java", 231, 0, 102, 60, 393
"c:\Users\zipasink\OneDrive\PhD\research\research-workspace\interactive-auto-mapping-tool\test-systems\Jabref\sources\3.7\src\main\java\net\sf\jabref\gui\groups\GroupAddRemoveDialog.java", "Java", 157, 0, 25, 39, 221
"c:\Users\zipasink\OneDrive\PhD\research\research-workspace\interactive-auto-mapping-tool\test-systems\Jabref\sources\3.7\src\main\java\net\sf\jabref\gui\groups\GroupDialog.java", "Java", 408, 0, 41, 38, 487
"c:\Users\zipasink\OneDrive\PhD\research\research-workspace\interactive-auto-mapping-tool\test-systems\Jabref\sources\3.7\src\main\java\net\sf\jabref\gui\groups\GroupMatcher.java", "Java", 10, 0, 4, 6, 20
"c:\Users\zipasink\OneDrive\PhD\research\research-workspace\interactive-auto-mapping-tool\test-systems\Jabref\sources\3.7\src\main\java\net\sf\jabref\gui\groups\GroupSelector.java", "Java", 1042, 0, 96, 150, 1288
"c:\Users\zipasink\OneDrive\PhD\research\research-workspace\interactive-auto-mapping-tool\test-systems\Jabref\sources\3.7\src\main\java\net\sf\jabref\gui\groups\GroupTreeCellRenderer.java", "Java", 103, 0, 26, 20, 149
"c:\Users\zipasink\OneDrive\PhD\research\research-workspace\interactive-auto-mapping-tool\test-systems\Jabref\sources\3.7\src\main\java\net\sf\jabref\gui\groups\GroupTreeNodeViewModel.java", "Java", 338, 0, 19, 69, 426
"c:\Users\zipasink\OneDrive\PhD\research\research-workspace\interactive-auto-mapping-tool\test-systems\Jabref\sources\3.7\src\main\java\net\sf\jabref\gui\groups\GroupsTree.java", "Java", 314, 0, 81, 48, 443
"c:\Users\zipasink\OneDrive\PhD\research\research-workspace\interactive-auto-mapping-tool\test-systems\Jabref\sources\3.7\src\main\java\net\sf\jabref\gui\groups\RemoveFromGroupAction.java", "Java", 39, 0, 1, 14, 54
"c:\Users\zipasink\OneDrive\PhD\research\research-workspace\interactive-auto-mapping-tool\test-systems\Jabref\sources\3.7\src\main\java\net\sf\jabref\gui\groups\TransferableEntrySelection.java", "Java", 70, 0, 1, 15, 86
"c:\Users\zipasink\OneDrive\PhD\research\research-workspace\interactive-auto-mapping-tool\test-systems\Jabref\sources\3.7\src\main\java\net\sf\jabref\gui\groups\UndoableAddOrRemoveGroup.java", "Java", 94, 0, 37, 13, 144
"c:\Users\zipasink\OneDrive\PhD\research\research-workspace\interactive-auto-mapping-tool\test-systems\Jabref\sources\3.7\src\main\java\net\sf\jabref\gui\groups\UndoableChangeAssignment.java", "Java", 42, 0, 12, 12, 66
"c:\Users\zipasink\OneDrive\PhD\research\research-workspace\interactive-auto-mapping-tool\test-systems\Jabref\sources\3.7\src\main\java\net\sf\jabref\gui\groups\UndoableChangeEntriesOfGroup.java", "Java", 25, 0, 0, 8, 33
"c:\Users\zipasink\OneDrive\PhD\research\research-workspace\interactive-auto-mapping-tool\test-systems\Jabref\sources\3.7\src\main\java\net\sf\jabref\gui\groups\UndoableModifyGroup.java", "Java", 39, 0, 8, 10, 57
"c:\Users\zipasink\OneDrive\PhD\research\research-workspace\interactive-auto-mapping-tool\test-systems\Jabref\sources\3.7\src\main\java\net\sf\jabref\gui\groups\UndoableModifySubtree.java", "Java", 45, 0, 12, 10, 67
"c:\Users\zipasink\OneDrive\PhD\research\research-workspace\interactive-auto-mapping-tool\test-systems\Jabref\sources\3.7\src\main\java\net\sf\jabref\gui\groups\UndoableMoveGroup.java", "Java", 40, 0, 6, 12, 58
"c:\Users\zipasink\OneDrive\PhD\research\research-workspace\interactive-auto-mapping-tool\test-systems\Jabref\sources\3.7\src\main\java\net\sf\jabref\gui\groups\WarnAssignmentSideEffects.java", "Java", 49, 0, 36, 10, 95
"c:\Users\zipasink\OneDrive\PhD\research\research-workspace\interactive-auto-mapping-tool\test-systems\Jabref\sources\3.7\src\main\java\net\sf\jabref\gui\help\AboutAction.java", "Java", 20, 0, 0, 7, 27
"c:\Users\zipasink\OneDrive\PhD\research\research-workspace\interactive-auto-mapping-tool\test-systems\Jabref\sources\3.7\src\main\java\net\sf\jabref\gui\help\AboutDialog.java", "Java", 80, 0, 1, 18, 99
"c:\Users\zipasink\OneDrive\PhD\research\research-workspace\interactive-auto-mapping-tool\test-systems\Jabref\sources\3.7\src\main\java\net\sf\jabref\gui\help\HelpAction.java", "Java", 85, 0, 7, 20, 112
"c:\Users\zipasink\OneDrive\PhD\research\research-workspace\interactive-auto-mapping-tool\test-systems\Jabref\sources\3.7\src\main\java\net\sf\jabref\gui\help\NewVersionDialog.java", "Java", 75, 0, 0, 21, 96
"c:\Users\zipasink\OneDrive\PhD\research\research-workspace\interactive-auto-mapping-tool\test-systems\Jabref\sources\3.7\src\main\java\net\sf\jabref\gui\importer\EntryFromExternalFileCreator.java", "Java", 25, 0, 3, 9, 37
"c:\Users\zipasink\OneDrive\PhD\research\research-workspace\interactive-auto-mapping-tool\test-systems\Jabref\sources\3.7\src\main\java\net\sf\jabref\gui\importer\EntryFromFileCreator.java", "Java", 106, 0, 61, 26, 193
"c:\Users\zipasink\OneDrive\PhD\research\research-workspace\interactive-auto-mapping-tool\test-systems\Jabref\sources\3.7\src\main\java\net\sf\jabref\gui\importer\EntryFromFileCreatorManager.java", "Java", 134, 0, 66, 24, 224
"c:\Users\zipasink\OneDrive\PhD\research\research-workspace\interactive-auto-mapping-tool\test-systems\Jabref\sources\3.7\src\main\java\net\sf\jabref\gui\importer\EntryFromPDFCreator.java", "Java", 86, 0, 34, 18, 138
"c:\Users\zipasink\OneDrive\PhD\research\research-workspace\interactive-auto-mapping-tool\test-systems\Jabref\sources\3.7\src\main\java\net\sf\jabref\gui\importer\FetcherPreviewDialog.java", "Java", 239, 0, 21, 56, 316
"c:\Users\zipasink\OneDrive\PhD\research\research-workspace\interactive-auto-mapping-tool\test-systems\Jabref\sources\3.7\src\main\java\net\sf\jabref\gui\importer\ImportCustomizationDialog.java", "Java", 240, 0, 25, 41, 306
"c:\Users\zipasink\OneDrive\PhD\research\research-workspace\interactive-auto-mapping-tool\test-systems\Jabref\sources\3.7\src\main\java\net\sf\jabref\gui\importer\ImportFileFilter.java", "Java", 51, 0, 0, 14, 65
"c:\Users\zipasink\OneDrive\PhD\research\research-workspace\interactive-auto-mapping-tool\test-systems\Jabref\sources\3.7\src\main\java\net\sf\jabref\gui\importer\ImportFormats.java", "Java", 74, 0, 10, 17, 101
"c:\Users\zipasink\OneDrive\PhD\research\research-workspace\interactive-auto-mapping-tool\test-systems\Jabref\sources\3.7\src\main\java\net\sf\jabref\gui\importer\ImportInspectionDialog.java", "Java", 1106, 0, 209, 178, 1493
"c:\Users\zipasink\OneDrive\PhD\research\research-workspace\interactive-auto-mapping-tool\test-systems\Jabref\sources\3.7\src\main\java\net\sf\jabref\gui\importer\ImportMenuItem.java", "Java", 187, 0, 28, 41, 256
"c:\Users\zipasink\OneDrive\PhD\research\research-workspace\interactive-auto-mapping-tool\test-systems\Jabref\sources\3.7\src\main\java\net\sf\jabref\gui\importer\ParserResultWarningDialog.java", "Java", 49, 0, 23, 13, 85
"c:\Users\zipasink\OneDrive\PhD\research\research-workspace\interactive-auto-mapping-tool\test-systems\Jabref\sources\3.7\src\main\java\net\sf\jabref\gui\importer\UnlinkedFilesCrawler.java", "Java", 63, 0, 25, 17, 105
"c:\Users\zipasink\OneDrive\PhD\research\research-workspace\interactive-auto-mapping-tool\test-systems\Jabref\sources\3.7\src\main\java\net\sf\jabref\gui\importer\UnlinkedPDFFileFilter.java", "Java", 20, 0, 13, 8, 41
"c:\Users\zipasink\OneDrive\PhD\research\research-workspace\interactive-auto-mapping-tool\test-systems\Jabref\sources\3.7\src\main\java\net\sf\jabref\gui\importer\ZipFileChooser.java", "Java", 145, 0, 70, 31, 246
"c:\Users\zipasink\OneDrive\PhD\research\research-workspace\interactive-auto-mapping-tool\test-systems\Jabref\sources\3.7\src\main\java\net\sf\jabref\gui\importer\actions\AppendDatabaseAction.java", "Java", 130, 0, 8, 23, 161
"c:\Users\zipasink\OneDrive\PhD\research\research-workspace\interactive-auto-mapping-tool\test-systems\Jabref\sources\3.7\src\main\java\net\sf\jabref\gui\importer\actions\CheckForNewEntryTypesAction.java", "Java", 51, 0, 6, 9, 66
"c:\Users\zipasink\OneDrive\PhD\research\research-workspace\interactive-auto-mapping-tool\test-systems\Jabref\sources\3.7\src\main\java\net\sf\jabref\gui\importer\actions\ConvertLegacyExplicitGroups.java", "Java", 45, 0, 4, 11, 60
"c:\Users\zipasink\OneDrive\PhD\research\research-workspace\interactive-auto-mapping-tool\test-systems\Jabref\sources\3.7\src\main\java\net\sf\jabref\gui\importer\actions\HandleDuplicateWarnings.java", "Java", 22, 0, 4, 6, 32
"c:\Users\zipasink\OneDrive\PhD\research\research-workspace\interactive-auto-mapping-tool\test-systems\Jabref\sources\3.7\src\main\java\net\sf\jabref\gui\importer\actions\OpenDatabaseAction.java", "Java", 208, 0, 41, 38, 287
"c:\Users\zipasink\OneDrive\PhD\research\research-workspace\interactive-auto-mapping-tool\test-systems\Jabref\sources\3.7\src\main\java\net\sf\jabref\gui\importer\actions\PostOpenAction.java", "Java", 7, 0, 27, 5, 39
"c:\Users\zipasink\OneDrive\PhD\research\research-workspace\interactive-auto-mapping-tool\test-systems\Jabref\sources\3.7\src\main\java\net\sf\jabref\gui\importer\fetcher\ACMPortalFetcher.java", "Java", 313, 0, 25, 67, 405
"c:\Users\zipasink\OneDrive\PhD\research\research-workspace\interactive-auto-mapping-tool\test-systems\Jabref\sources\3.7\src\main\java\net\sf\jabref\gui\importer\fetcher\CiteSeerXFetcher.java", "Java", 126, 0, 11, 29, 166
"c:\Users\zipasink\OneDrive\PhD\research\research-workspace\interactive-auto-mapping-tool\test-systems\Jabref\sources\3.7\src\main\java\net\sf\jabref\gui\importer\fetcher\DOAJFetcher.java", "Java", 101, 0, 1, 18, 120
"c:\Users\zipasink\OneDrive\PhD\research\research-workspace\interactive-auto-mapping-tool\test-systems\Jabref\sources\3.7\src\main\java\net\sf\jabref\gui\importer\fetcher\EntryFetcher.java", "Java", 13, 0, 52, 8, 73
"c:\Users\zipasink\OneDrive\PhD\research\research-workspace\interactive-auto-mapping-tool\test-systems\Jabref\sources\3.7\src\main\java\net\sf\jabref\gui\importer\fetcher\EntryFetchers.java", "Java", 52, 0, 2, 9, 63
"c:\Users\zipasink\OneDrive\PhD\research\research-workspace\interactive-auto-mapping-tool\test-systems\Jabref\sources\3.7\src\main\java\net\sf\jabref\gui\importer\fetcher\GeneralFetcher.java", "Java", 215, 0, 8, 34, 257
"c:\Users\zipasink\OneDrive\PhD\research\research-workspace\interactive-auto-mapping-tool\test-systems\Jabref\sources\3.7\src\main\java\net\sf\jabref\gui\importer\fetcher\IEEEXploreFetcher.java", "Java", 363, 0, 52, 73, 488
"c:\Users\zipasink\OneDrive\PhD\research\research-workspace\interactive-auto-mapping-tool\test-systems\Jabref\sources\3.7\src\main\java\net\sf\jabref\gui\importer\fetcher\INSPIREFetcher.java", "Java", 79, 0, 64, 19, 162
"c:\Users\zipasink\OneDrive\PhD\research\research-workspace\interactive-auto-mapping-tool\test-systems\Jabref\sources\3.7\src\main\java\net\sf\jabref\gui\importer\fetcher\IdBasedEntryFetcher.java", "Java", 49, 0, 2, 15, 66
"c:\Users\zipasink\OneDrive\PhD\research\research-workspace\interactive-auto-mapping-tool\test-systems\Jabref\sources\3.7\src\main\java\net\sf\jabref\gui\importer\fetcher\OAI2Fetcher.java", "Java", 178, 0, 71, 39, 288
"c:\Users\zipasink\OneDrive\PhD\research\research-workspace\interactive-auto-mapping-tool\test-systems\Jabref\sources\3.7\src\main\java\net\sf\jabref\gui\importer\fetcher\PreviewEntryFetcher.java", "Java", 12, 0, 11, 9, 32
"c:\Users\zipasink\OneDrive\PhD\research\research-workspace\interactive-auto-mapping-tool\test-systems\Jabref\sources\3.7\src\main\java\net\sf\jabref\gui\importer\fetcher\ScienceDirectFetcher.java", "Java", 106, 0, 13, 24, 143
"c:\Users\zipasink\OneDrive\PhD\research\research-workspace\interactive-auto-mapping-tool\test-systems\Jabref\sources\3.7\src\main\java\net\sf\jabref\gui\importer\fetcher\SearchBasedEntryFetcher.java", "Java", 49, 0, 5, 15, 69
"c:\Users\zipasink\OneDrive\PhD\research\research-workspace\interactive-auto-mapping-tool\test-systems\Jabref\sources\3.7\src\main\java\net\sf\jabref\gui\importer\fetcher\SpringerFetcher.java", "Java", 105, 0, 1, 18, 124
"c:\Users\zipasink\OneDrive\PhD\research\research-workspace\interactive-auto-mapping-tool\test-systems\Jabref\sources\3.7\src\main\java\net\sf\jabref\gui\journals\AbbreviateAction.java", "Java", 52, 0, 3, 13, 68
"c:\Users\zipasink\OneDrive\PhD\research\research-workspace\interactive-auto-mapping-tool\test-systems\Jabref\sources\3.7\src\main\java\net\sf\jabref\gui\journals\JournalAbbreviationsUtil.java", "Java", 24, 0, 0, 8, 32
"c:\Users\zipasink\OneDrive\PhD\research\research-workspace\interactive-auto-mapping-tool\test-systems\Jabref\sources\3.7\src\main\java\net\sf\jabref\gui\journals\ManageJournalsAction.java", "Java", 21, 0, 0, 8, 29
"c:\Users\zipasink\OneDrive\PhD\research\research-workspace\interactive-auto-mapping-tool\test-systems\Jabref\sources\3.7\src\main\java\net\sf\jabref\gui\journals\ManageJournalsPanel.java", "Java", 542, 0, 8, 97, 647
"c:\Users\zipasink\OneDrive\PhD\research\research-workspace\interactive-auto-mapping-tool\test-systems\Jabref\sources\3.7\src\main\java\net\sf\jabref\gui\journals\UnabbreviateAction.java", "Java", 50, 0, 3, 12, 65
"c:\Users\zipasink\OneDrive\PhD\research\research-workspace\interactive-auto-mapping-tool\test-systems\Jabref\sources\3.7\src\main\java\net\sf\jabref\gui\journals\UndoableAbbreviator.java", "Java", 42, 0, 9, 14, 65
"c:\Users\zipasink\OneDrive\PhD\research\research-workspace\interactive-auto-mapping-tool\test-systems\Jabref\sources\3.7\src\main\java\net\sf\jabref\gui\journals\UndoableUnabbreviator.java", "Java", 34, 0, 8, 12, 54
"c:\Users\zipasink\OneDrive\PhD\research\research-workspace\interactive-auto-mapping-tool\test-systems\Jabref\sources\3.7\src\main\java\net\sf\jabref\gui\keyboard\EmacsKeyBindings.java", "Java", 622, 0, 116, 106, 844
"c:\Users\zipasink\OneDrive\PhD\research\research-workspace\interactive-auto-mapping-tool\test-systems\Jabref\sources\3.7\src\main\java\net\sf\jabref\gui\keyboard\KeyBinder.java", "Java", 15, 0, 6, 6, 27
"c:\Users\zipasink\OneDrive\PhD\research\research-workspace\interactive-auto-mapping-tool\test-systems\Jabref\sources\3.7\src\main\java\net\sf\jabref\gui\keyboard\KeyBinding.java", "Java", 107, 0, 0, 10, 117
"c:\Users\zipasink\OneDrive\PhD\research\research-workspace\interactive-auto-mapping-tool\test-systems\Jabref\sources\3.7\src\main\java\net\sf\jabref\gui\keyboard\KeyBindingPreferences.java", "Java", 81, 0, 18, 26, 125
"c:\Users\zipasink\OneDrive\PhD\research\research-workspace\interactive-auto-mapping-tool\test-systems\Jabref\sources\3.7\src\main\java\net\sf\jabref\gui\keyboard\KeyBindingRepository.java", "Java", 59, 0, 3, 19, 81
"c:\Users\zipasink\OneDrive\PhD\research\research-workspace\interactive-auto-mapping-tool\test-systems\Jabref\sources\3.7\src\main\java\net\sf\jabref\gui\keyboard\KeyBindingTable.java", "Java", 12, 0, 0, 6, 18
"c:\Users\zipasink\OneDrive\PhD\research\research-workspace\interactive-auto-mapping-tool\test-systems\Jabref\sources\3.7\src\main\java\net\sf\jabref\gui\keyboard\KeyBindingTableModel.java", "Java", 51, 0, 0, 15, 66
"c:\Users\zipasink\OneDrive\PhD\research\research-workspace\interactive-auto-mapping-tool\test-systems\Jabref\sources\3.7\src\main\java\net\sf\jabref\gui\keyboard\KeyBindingsDialog.java", "Java", 111, 0, 9, 24, 144
"c:\Users\zipasink\OneDrive\PhD\research\research-workspace\interactive-auto-mapping-tool\test-systems\Jabref\sources\3.7\src\main\java\net\sf\jabref\gui\keyboard\KeyBindingsListener.java", "Java", 81, 0, 18, 13, 112
"c:\Users\zipasink\OneDrive\PhD\research\research-workspace\interactive-auto-mapping-tool\test-systems\Jabref\sources\3.7\src\main\java\net\sf\jabref\gui\maintable\ListSynchronizer.java", "Java", 51, 0, 1, 11, 63
"c:\Users\zipasink\OneDrive\PhD\research\research-workspace\interactive-auto-mapping-tool\test-systems\Jabref\sources\3.7\src\main\java\net\sf\jabref\gui\maintable\MainTable.java", "Java", 552, 0, 77, 101, 730
"c:\Users\zipasink\OneDrive\PhD\research\research-workspace\interactive-auto-mapping-tool\test-systems\Jabref\sources\3.7\src\main\java\net\sf\jabref\gui\maintable\MainTableColumn.java", "Java", 113, 0, 18, 30, 161
"c:\Users\zipasink\OneDrive\PhD\research\research-workspace\interactive-auto-mapping-tool\test-systems\Jabref\sources\3.7\src\main\java\net\sf\jabref\gui\maintable\MainTableDataModel.java", "Java", 185, 0, 15, 47, 247
"c:\Users\zipasink\OneDrive\PhD\research\research-workspace\interactive-auto-mapping-tool\test-systems\Jabref\sources\3.7\src\main\java\net\sf\jabref\gui\maintable\MainTableFormat.java", "Java", 101, 0, 23, 32, 156
"c:\Users\zipasink\OneDrive\PhD\research\research-workspace\interactive-auto-mapping-tool\test-systems\Jabref\sources\3.7\src\main\java\net\sf\jabref\gui\maintable\MainTableHeaderRenderer.java", "Java", 28, 0, 2, 9, 39
"c:\Users\zipasink\OneDrive\PhD\research\research-workspace\interactive-auto-mapping-tool\test-systems\Jabref\sources\3.7\src\main\java\net\sf\jabref\gui\maintable\MainTableNameFormatter.java", "Java", 26, 0, 8, 9, 43
"c:\Users\zipasink\OneDrive\PhD\research\research-workspace\interactive-auto-mapping-tool\test-systems\Jabref\sources\3.7\src\main\java\net\sf\jabref\gui\maintable\MainTableSelectionListener.java", "Java", 421, 0, 83, 62, 566
"c:\Users\zipasink\OneDrive\PhD\research\research-workspace\interactive-auto-mapping-tool\test-systems\Jabref\sources\3.7\src\main\java\net\sf\jabref\gui\maintable\PersistenceTableColumnListener.java", "Java", 64, 0, 39, 26, 129
"c:\Users\zipasink\OneDrive\PhD\research\research-workspace\interactive-auto-mapping-tool\test-systems\Jabref\sources\3.7\src\main\java\net\sf\jabref\gui\maintable\PreventDraggingJTableHeader.java", "Java", 54, 0, 25, 19, 98
"c:\Users\zipasink\OneDrive\PhD\research\research-workspace\interactive-auto-mapping-tool\test-systems\Jabref\sources\3.7\src\main\java\net\sf\jabref\gui\maintable\SpecialMainTableColumnsBuilder.java", "Java", 149, 0, 18, 38, 205
"c:\Users\zipasink\OneDrive\PhD\research\research-workspace\interactive-auto-mapping-tool\test-systems\Jabref\sources\3.7\src\main\java\net\sf\jabref\gui\menus\ChangeEntryTypeMenu.java", "Java", 67, 0, 9, 11, 87
"c:\Users\zipasink\OneDrive\PhD\research\research-workspace\interactive-auto-mapping-tool\test-systems\Jabref\sources\3.7\src\main\java\net\sf\jabref\gui\menus\FileHistoryMenu.java", "Java", 75, 0, 8, 18, 101
"c:\Users\zipasink\OneDrive\PhD\research\research-workspace\interactive-auto-mapping-tool\test-systems\Jabref\sources\3.7\src\main\java\net\sf\jabref\gui\menus\RightClickMenu.java", "Java", 232, 0, 16, 56, 304
"c:\Users\zipasink\OneDrive\PhD\research\research-workspace\interactive-auto-mapping-tool\test-systems\Jabref\sources\3.7\src\main\java\net\sf\jabref\gui\mergeentries\FetchAndMergeEntry.java", "Java", 28, 0, 19, 8, 55
"c:\Users\zipasink\OneDrive\PhD\research\research-workspace\interactive-auto-mapping-tool\test-systems\Jabref\sources\3.7\src\main\java\net\sf\jabref\gui\mergeentries\FetchAndMergeWorker.java", "Java", 61, 0, 0, 17, 78
"c:\Users\zipasink\OneDrive\PhD\research\research-workspace\interactive-auto-mapping-tool\test-systems\Jabref\sources\3.7\src\main\java\net\sf\jabref\gui\mergeentries\MergeEntries.java", "Java", 337, 0, 54, 63, 454
"c:\Users\zipasink\OneDrive\PhD\research\research-workspace\interactive-auto-mapping-tool\test-systems\Jabref\sources\3.7\src\main\java\net\sf\jabref\gui\mergeentries\MergeEntriesDialog.java", "Java", 81, 0, 19, 25, 125
"c:\Users\zipasink\OneDrive\PhD\research\research-workspace\interactive-auto-mapping-tool\test-systems\Jabref\sources\3.7\src\main\java\net\sf\jabref\gui\mergeentries\MergeFetchedEntryDialog.java", "Java", 122, 0, 14, 32, 168
"c:\Users\zipasink\OneDrive\PhD\research\research-workspace\interactive-auto-mapping-tool\test-systems\Jabref\sources\3.7\src\main\java\net\sf\jabref\gui\net\MonitoredURLDownload.java", "Java", 16, 0, 0, 7, 23
"c:\Users\zipasink\OneDrive\PhD\research\research-workspace\interactive-auto-mapping-tool\test-systems\Jabref\sources\3.7\src\main\java\net\sf\jabref\gui\openoffice\AdvancedCiteDialog.java", "Java", 89, 0, 3, 21, 113
"c:\Users\zipasink\OneDrive\PhD\research\research-workspace\interactive-auto-mapping-tool\test-systems\Jabref\sources\3.7\src\main\java\net\sf\jabref\gui\openoffice\AutoDetectPaths.java", "Java", 237, 0, 5, 28, 270
"c:\Users\zipasink\OneDrive\PhD\research\research-workspace\interactive-auto-mapping-tool\test-systems\Jabref\sources\3.7\src\main\java\net\sf\jabref\gui\openoffice\BibEntryNotFoundException.java", "Java", 11, 0, 7, 7, 25
"c:\Users\zipasink\OneDrive\PhD\research\research-workspace\interactive-auto-mapping-tool\test-systems\Jabref\sources\3.7\src\main\java\net\sf\jabref\gui\openoffice\CitationManager.java", "Java", 198, 0, 3, 42, 243
"c:\Users\zipasink\OneDrive\PhD\research\research-workspace\interactive-auto-mapping-tool\test-systems\Jabref\sources\3.7\src\main\java\net\sf\jabref\gui\openoffice\ConnectionLostException.java", "Java", 6, 0, 3, 3, 12
"c:\Users\zipasink\OneDrive\PhD\research\research-workspace\interactive-auto-mapping-tool\test-systems\Jabref\sources\3.7\src\main\java\net\sf\jabref\gui\openoffice\CreationException.java", "Java", 6, 0, 4, 4, 14
"c:\Users\zipasink\OneDrive\PhD\research\research-workspace\interactive-auto-mapping-tool\test-systems\Jabref\sources\3.7\src\main\java\net\sf\jabref\gui\openoffice\NoDocumentException.java", "Java", 6, 0, 4, 4, 14
"c:\Users\zipasink\OneDrive\PhD\research\research-workspace\interactive-auto-mapping-tool\test-systems\Jabref\sources\3.7\src\main\java\net\sf\jabref\gui\openoffice\OOBibBase.java", "Java", 1079, 0, 156, 154, 1389
"c:\Users\zipasink\OneDrive\PhD\research\research-workspace\interactive-auto-mapping-tool\test-systems\Jabref\sources\3.7\src\main\java\net\sf\jabref\gui\openoffice\OpenOfficePanel.java", "Java", 657, 0, 31, 98, 786
"c:\Users\zipasink\OneDrive\PhD\research\research-workspace\interactive-auto-mapping-tool\test-systems\Jabref\sources\3.7\src\main\java\net\sf\jabref\gui\openoffice\OpenOfficeSidePanel.java", "Java", 40, 0, 0, 13, 53
"c:\Users\zipasink\OneDrive\PhD\research\research-workspace\interactive-auto-mapping-tool\test-systems\Jabref\sources\3.7\src\main\java\net\sf\jabref\gui\openoffice\StyleSelectDialog.java", "Java", 423, 0, 37, 79, 539
"c:\Users\zipasink\OneDrive\PhD\research\research-workspace\interactive-auto-mapping-tool\test-systems\Jabref\sources\3.7\src\main\java\net\sf\jabref\gui\openoffice\UndefinedCharacterFormatException.java", "Java", 11, 0, 4, 6, 21
"c:\Users\zipasink\OneDrive\PhD\research\research-workspace\interactive-auto-mapping-tool\test-systems\Jabref\sources\3.7\src\main\java\net\sf\jabref\gui\plaintextimport\BasicAction.java", "Java", 16, 0, 0, 6, 22
"c:\Users\zipasink\OneDrive\PhD\research\research-workspace\interactive-auto-mapping-tool\test-systems\Jabref\sources\3.7\src\main\java\net\sf\jabref\gui\plaintextimport\PopupListener.java", "Java", 23, 0, 0, 9, 32
"c:\Users\zipasink\OneDrive\PhD\research\research-workspace\interactive-auto-mapping-tool\test-systems\Jabref\sources\3.7\src\main\java\net\sf\jabref\gui\plaintextimport\TagToMarkedTextStore.java", "Java", 54, 0, 7, 22, 83
"c:\Users\zipasink\OneDrive\PhD\research\research-workspace\interactive-auto-mapping-tool\test-systems\Jabref\sources\3.7\src\main\java\net\sf\jabref\gui\plaintextimport\TextInputDialog.java", "Java", 519, 0, 61, 119, 699
"c:\Users\zipasink\OneDrive\PhD\research\research-workspace\interactive-auto-mapping-tool\test-systems\Jabref\sources\3.7\src\main\java\net\sf\jabref\gui\preftabs\AdvancedTab.java", "Java", 141, 0, 1, 28, 170
"c:\Users\zipasink\OneDrive\PhD\research\research-workspace\interactive-auto-mapping-tool\test-systems\Jabref\sources\3.7\src\main\java\net\sf\jabref\gui\preftabs\AppearancePrefsTab.java", "Java", 236, 0, 17, 35, 288
"c:\Users\zipasink\OneDrive\PhD\research\research-workspace\interactive-auto-mapping-tool\test-systems\Jabref\sources\3.7\src\main\java\net\sf\jabref\gui\preftabs\BibtexKeyPatternPrefTab.java", "Java", 128, 0, 13, 31, 172
"c:\Users\zipasink\OneDrive\PhD\research\research-workspace\interactive-auto-mapping-tool\test-systems\Jabref\sources\3.7\src\main\java\net\sf\jabref\gui\preftabs\ColorSetupPanel.java", "Java", 157, 0, 11, 38, 206
"c:\Users\zipasink\OneDrive\PhD\research\research-workspace\interactive-auto-mapping-tool\test-systems\Jabref\sources\3.7\src\main\java\net\sf\jabref\gui\preftabs\EntryEditorPrefsTab.java", "Java", 202, 0, 14, 34, 250
"c:\Users\zipasink\OneDrive\PhD\research\research-workspace\interactive-auto-mapping-tool\test-systems\Jabref\sources\3.7\src\main\java\net\sf\jabref\gui\preftabs\ExternalTab.java", "Java", 155, 0, 0, 46, 201
"c:\Users\zipasink\OneDrive\PhD\research\research-workspace\interactive-auto-mapping-tool\test-systems\Jabref\sources\3.7\src\main\java\net\sf\jabref\gui\preftabs\FileSortTab.java", "Java", 84, 0, 7, 23, 114
"c:\Users\zipasink\OneDrive\PhD\research\research-workspace\interactive-auto-mapping-tool\test-systems\Jabref\sources\3.7\src\main\java\net\sf\jabref\gui\preftabs\FileTab.java", "Java", 224, 0, 7, 41, 272
"c:\Users\zipasink\OneDrive\PhD\research\research-workspace\interactive-auto-mapping-tool\test-systems\Jabref\sources\3.7\src\main\java\net\sf\jabref\gui\preftabs\FontSelectorDialog.java", "Java", 207, 0, 87, 57, 351
"c:\Users\zipasink\OneDrive\PhD\research\research-workspace\interactive-auto-mapping-tool\test-systems\Jabref\sources\3.7\src\main\java\net\sf\jabref\gui\preftabs\GeneralTab.java", "Java", 223, 0, 6, 37, 266
"c:\Users\zipasink\OneDrive\PhD\research\research-workspace\interactive-auto-mapping-tool\test-systems\Jabref\sources\3.7\src\main\java\net\sf\jabref\gui\preftabs\GroupsPrefsTab.java", "Java", 104, 0, 2, 20, 126
"c:\Users\zipasink\OneDrive\PhD\research\research-workspace\interactive-auto-mapping-tool\test-systems\Jabref\sources\3.7\src\main\java\net\sf\jabref\gui\preftabs\ImportSettingsTab.java", "Java", 143, 0, 1, 24, 168
"c:\Users\zipasink\OneDrive\PhD\research\research-workspace\interactive-auto-mapping-tool\test-systems\Jabref\sources\3.7\src\main\java\net\sf\jabref\gui\preftabs\NameFormatterTab.java", "Java", 249, 0, 17, 69, 335
"c:\Users\zipasink\OneDrive\PhD\research\research-workspace\interactive-auto-mapping-tool\test-systems\Jabref\sources\3.7\src\main\java\net\sf\jabref\gui\preftabs\NetworkTab.java", "Java", 149, 0, 2, 25, 176
"c:\Users\zipasink\OneDrive\PhD\research\research-workspace\interactive-auto-mapping-tool\test-systems\Jabref\sources\3.7\src\main\java\net\sf\jabref\gui\preftabs\PreferencesDialog.java", "Java", 240, 0, 18, 51, 309
"c:\Users\zipasink\OneDrive\PhD\research\research-workspace\interactive-auto-mapping-tool\test-systems\Jabref\sources\3.7\src\main\java\net\sf\jabref\gui\preftabs\PreferencesFilterDialog.java", "Java", 102, 0, 0, 27, 129
"c:\Users\zipasink\OneDrive\PhD\research\research-workspace\interactive-auto-mapping-tool\test-systems\Jabref\sources\3.7\src\main\java\net\sf\jabref\gui\preftabs\PrefsTab.java", "Java", 7, 0, 30, 6, 43
"c:\Users\zipasink\OneDrive\PhD\research\research-workspace\interactive-auto-mapping-tool\test-systems\Jabref\sources\3.7\src\main\java\net\sf\jabref\gui\preftabs\PreviewPrefsTab.java", "Java", 218, 0, 1, 45, 264
"c:\Users\zipasink\OneDrive\PhD\research\research-workspace\interactive-auto-mapping-tool\test-systems\Jabref\sources\3.7\src\main\java\net\sf\jabref\gui\preftabs\TableColumnsTab.java", "Java", 646, 0, 40, 111, 797
"c:\Users\zipasink\OneDrive\PhD\research\research-workspace\interactive-auto-mapping-tool\test-systems\Jabref\sources\3.7\src\main\java\net\sf\jabref\gui\preftabs\TablePrefsTab.java", "Java", 241, 0, 20, 42, 303
"c:\Users\zipasink\OneDrive\PhD\research\research-workspace\interactive-auto-mapping-tool\test-systems\Jabref\sources\3.7\src\main\java\net\sf\jabref\gui\preftabs\XmpPrefsTab.java", "Java", 202, 0, 23, 52, 277
"c:\Users\zipasink\OneDrive\PhD\research\research-workspace\interactive-auto-mapping-tool\test-systems\Jabref\sources\3.7\src\main\java\net\sf\jabref\gui\protectedterms\NewProtectedTermsFileDialog.java", "Java", 95, 0, 3, 17, 115
"c:\Users\zipasink\OneDrive\PhD\research\research-workspace\interactive-auto-mapping-tool\test-systems\Jabref\sources\3.7\src\main\java\net\sf\jabref\gui\protectedterms\ProtectedTermsDialog.java", "Java", 397, 0, 24, 79, 500
"c:\Users\zipasink\OneDrive\PhD\research\research-workspace\interactive-auto-mapping-tool\test-systems\Jabref\sources\3.7\src\main\java\net\sf\jabref\gui\push\AbstractPushToApplication.java", "Java", 119, 0, 25, 27, 171
"c:\Users\zipasink\OneDrive\PhD\research\research-workspace\interactive-auto-mapping-tool\test-systems\Jabref\sources\3.7\src\main\java\net\sf\jabref\gui\push\PushToApplication.java", "Java", 19, 0, 33, 15, 67
"c:\Users\zipasink\OneDrive\PhD\research\research-workspace\interactive-auto-mapping-tool\test-systems\Jabref\sources\3.7\src\main\java\net\sf\jabref\gui\push\PushToApplicationAction.java", "Java", 73, 0, 11, 15, 99
"c:\Users\zipasink\OneDrive\PhD\research\research-workspace\interactive-auto-mapping-tool\test-systems\Jabref\sources\3.7\src\main\java\net\sf\jabref\gui\push\PushToApplicationButton.java", "Java", 228, 0, 33, 54, 315
"c:\Users\zipasink\OneDrive\PhD\research\research-workspace\interactive-auto-mapping-tool\test-systems\Jabref\sources\3.7\src\main\java\net\sf\jabref\gui\push\PushToApplications.java", "Java", 19, 0, 3, 9, 31
"c:\Users\zipasink\OneDrive\PhD\research\research-workspace\interactive-auto-mapping-tool\test-systems\Jabref\sources\3.7\src\main\java\net\sf\jabref\gui\push\PushToEmacs.java", "Java", 135, 0, 12, 26, 173
"c:\Users\zipasink\OneDrive\PhD\research\research-workspace\interactive-auto-mapping-tool\test-systems\Jabref\sources\3.7\src\main\java\net\sf\jabref\gui\push\PushToLatexEditor.java", "Java", 26, 0, 3, 10, 39
"c:\Users\zipasink\OneDrive\PhD\research\research-workspace\interactive-auto-mapping-tool\test-systems\Jabref\sources\3.7\src\main\java\net\sf\jabref\gui\push\PushToLyx.java", "Java", 93, 0, 1, 22, 116
"c:\Users\zipasink\OneDrive\PhD\research\research-workspace\interactive-auto-mapping-tool\test-systems\Jabref\sources\3.7\src\main\java\net\sf\jabref\gui\push\PushToTeXstudio.java", "Java", 22, 0, 4, 8, 34
"c:\Users\zipasink\OneDrive\PhD\research\research-workspace\interactive-auto-mapping-tool\test-systems\Jabref\sources\3.7\src\main\java\net\sf\jabref\gui\push\PushToTexmaker.java", "Java", 22, 0, 3, 9, 34
"c:\Users\zipasink\OneDrive\PhD\research\research-workspace\interactive-auto-mapping-tool\test-systems\Jabref\sources\3.7\src\main\java\net\sf\jabref\gui\push\PushToVim.java", "Java", 113, 0, 5, 25, 143
"c:\Users\zipasink\OneDrive\PhD\research\research-workspace\interactive-auto-mapping-tool\test-systems\Jabref\sources\3.7\src\main\java\net\sf\jabref\gui\push\PushToWinEdt.java", "Java", 23, 0, 0, 8, 31
"c:\Users\zipasink\OneDrive\PhD\research\research-workspace\interactive-auto-mapping-tool\test-systems\Jabref\sources\3.7\src\main\java\net\sf\jabref\gui\remote\JabRefMessageHandler.java", "Java", 21, 0, 0, 6, 27
"c:\Users\zipasink\OneDrive\PhD\research\research-workspace\interactive-auto-mapping-tool\test-systems\Jabref\sources\3.7\src\main\java\net\sf\jabref\gui\renderer\CompleteRenderer.java", "Java", 13, 0, 1, 6, 20
"c:\Users\zipasink\OneDrive\PhD\research\research-workspace\interactive-auto-mapping-tool\test-systems\Jabref\sources\3.7\src\main\java\net\sf\jabref\gui\renderer\GeneralRenderer.java", "Java", 64, 0, 18, 12, 94
"c:\Users\zipasink\OneDrive\PhD\research\research-workspace\interactive-auto-mapping-tool\test-systems\Jabref\sources\3.7\src\main\java\net\sf\jabref\gui\renderer\IncompleteRenderer.java", "Java", 16, 0, 1, 6, 23
"c:\Users\zipasink\OneDrive\PhD\research\research-workspace\interactive-auto-mapping-tool\test-systems\Jabref\sources\3.7\src\main\java\net\sf\jabref\gui\search\GlobalSearchBar.java", "Java", 345, 0, 11, 70, 426
"c:\Users\zipasink\OneDrive\PhD\research\research-workspace\interactive-auto-mapping-tool\test-systems\Jabref\sources\3.7\src\main\java\net\sf\jabref\gui\search\GlobalSearchWorker.java", "Java", 55, 0, 0, 15, 70
"c:\Users\zipasink\OneDrive\PhD\research\research-workspace\interactive-auto-mapping-tool\test-systems\Jabref\sources\3.7\src\main\java\net\sf\jabref\gui\search\HitOrMissComparator.java", "Java", 18, 0, 4, 9, 31
"c:\Users\zipasink\OneDrive\PhD\research\research-workspace\interactive-auto-mapping-tool\test-systems\Jabref\sources\3.7\src\main\java\net\sf\jabref\gui\search\JTextFieldChangeListenerUtil.java", "Java", 56, 0, 19, 10, 85
"c:\Users\zipasink\OneDrive\PhD\research\research-workspace\interactive-auto-mapping-tool\test-systems\Jabref\sources\3.7\src\main\java\net\sf\jabref\gui\search\SearchDisplayMode.java", "Java", 18, 0, 3, 9, 30
"c:\Users\zipasink\OneDrive\PhD\research\research-workspace\interactive-auto-mapping-tool\test-systems\Jabref\sources\3.7\src\main\java\net\sf\jabref\gui\search\SearchResultFrame.java", "Java", 507, 0, 63, 74, 644
"c:\Users\zipasink\OneDrive\PhD\research\research-workspace\interactive-auto-mapping-tool\test-systems\Jabref\sources\3.7\src\main\java\net\sf\jabref\gui\search\SearchWorker.java", "Java", 85, 0, 10, 21, 116
"c:\Users\zipasink\OneDrive\PhD\research\research-workspace\interactive-auto-mapping-tool\test-systems\Jabref\sources\3.7\src\main\java\net\sf\jabref\gui\search\matchers\EverythingMatcher.java", "Java", 10, 0, 4, 6, 20
"c:\Users\zipasink\OneDrive\PhD\research\research-workspace\interactive-auto-mapping-tool\test-systems\Jabref\sources\3.7\src\main\java\net\sf\jabref\gui\search\matchers\SearchMatcher.java", "Java", 10, 0, 4, 6, 20
"c:\Users\zipasink\OneDrive\PhD\research\research-workspace\interactive-auto-mapping-tool\test-systems\Jabref\sources\3.7\src\main\java\net\sf\jabref\gui\shared\ConnectToSharedDatabaseDialog.java", "Java", 360, 0, 35, 81, 476
"c:\Users\zipasink\OneDrive\PhD\research\research-workspace\interactive-auto-mapping-tool\test-systems\Jabref\sources\3.7\src\main\java\net\sf\jabref\gui\shared\MergeSharedEntryDialog.java", "Java", 91, 0, 0, 22, 113
"c:\Users\zipasink\OneDrive\PhD\research\research-workspace\interactive-auto-mapping-tool\test-systems\Jabref\sources\3.7\src\main\java\net\sf\jabref\gui\shared\MigrationHelpDialog.java", "Java", 64, 0, 0, 17, 81
"c:\Users\zipasink\OneDrive\PhD\research\research-workspace\interactive-auto-mapping-tool\test-systems\Jabref\sources\3.7\src\main\java\net\sf\jabref\gui\shared\SharedDatabaseUIManager.java", "Java", 110, 0, 7, 29, 146
"c:\Users\zipasink\OneDrive\PhD\research\research-workspace\interactive-auto-mapping-tool\test-systems\Jabref\sources\3.7\src\main\java\net\sf\jabref\gui\specialfields\SpecialFieldAction.java", "Java", 82, 0, 10, 14, 106
"c:\Users\zipasink\OneDrive\PhD\research\research-workspace\interactive-auto-mapping-tool\test-systems\Jabref\sources\3.7\src\main\java\net\sf\jabref\gui\specialfields\SpecialFieldDatabaseChangeListener.java", "Java", 31, 0, 4, 10, 45
"c:\Users\zipasink\OneDrive\PhD\research\research-workspace\interactive-auto-mapping-tool\test-systems\Jabref\sources\3.7\src\main\java\net\sf\jabref\gui\specialfields\SpecialFieldDropDown.java", "Java", 80, 0, 0, 23, 103
"c:\Users\zipasink\OneDrive\PhD\research\research-workspace\interactive-auto-mapping-tool\test-systems\Jabref\sources\3.7\src\main\java\net\sf\jabref\gui\specialfields\SpecialFieldMenuAction.java", "Java", 19, 0, 0, 9, 28
"c:\Users\zipasink\OneDrive\PhD\research\research-workspace\interactive-auto-mapping-tool\test-systems\Jabref\sources\3.7\src\main\java\net\sf\jabref\gui\specialfields\SpecialFieldUpdateListener.java", "Java", 37, 0, 9, 9, 55
"c:\Users\zipasink\OneDrive\PhD\research\research-workspace\interactive-auto-mapping-tool\test-systems\Jabref\sources\3.7\src\main\java\net\sf\jabref\gui\specialfields\SpecialFieldValueViewModel.java", "Java", 171, 0, 0, 17, 188
"c:\Users\zipasink\OneDrive\PhD\research\research-workspace\interactive-auto-mapping-tool\test-systems\Jabref\sources\3.7\src\main\java\net\sf\jabref\gui\specialfields\SpecialFieldViewModel.java", "Java", 56, 0, 2, 12, 70
"c:\Users\zipasink\OneDrive\PhD\research\research-workspace\interactive-auto-mapping-tool\test-systems\Jabref\sources\3.7\src\main\java\net\sf\jabref\gui\undo\AbstractUndoableJabRefEdit.java", "Java", 13, 0, 0, 8, 21
"c:\Users\zipasink\OneDrive\PhD\research\research-workspace\interactive-auto-mapping-tool\test-systems\Jabref\sources\3.7\src\main\java\net\sf\jabref\gui\undo\CountingUndoManager.java", "Java", 57, 0, 0, 17, 74
"c:\Users\zipasink\OneDrive\PhD\research\research-workspace\interactive-auto-mapping-tool\test-systems\Jabref\sources\3.7\src\main\java\net\sf\jabref\gui\undo\NamedCompound.java", "Java", 36, 0, 0, 12, 48
"c:\Users\zipasink\OneDrive\PhD\research\research-workspace\interactive-auto-mapping-tool\test-systems\Jabref\sources\3.7\src\main\java\net\sf\jabref\gui\undo\UndoableChangeType.java", "Java", 31, 0, 3, 7, 41
"c:\Users\zipasink\OneDrive\PhD\research\research-workspace\interactive-auto-mapping-tool\test-systems\Jabref\sources\3.7\src\main\java\net\sf\jabref\gui\undo\UndoableFieldChange.java", "Java", 57, 0, 8, 16, 81
"c:\Users\zipasink\OneDrive\PhD\research\research-workspace\interactive-auto-mapping-tool\test-systems\Jabref\sources\3.7\src\main\java\net\sf\jabref\gui\undo\UndoableInsertEntry.java", "Java", 40, 0, 8, 13, 61
"c:\Users\zipasink\OneDrive\PhD\research\research-workspace\interactive-auto-mapping-tool\test-systems\Jabref\sources\3.7\src\main\java\net\sf\jabref\gui\undo\UndoableInsertString.java", "Java", 41, 0, 2, 15, 58
"c:\Users\zipasink\OneDrive\PhD\research\research-workspace\interactive-auto-mapping-tool\test-systems\Jabref\sources\3.7\src\main\java\net\sf\jabref\gui\undo\UndoableKeyChange.java", "Java", 30, 0, 5, 10, 45
"c:\Users\zipasink\OneDrive\PhD\research\research-workspace\interactive-auto-mapping-tool\test-systems\Jabref\sources\3.7\src\main\java\net\sf\jabref\gui\undo\UndoablePreambleChange.java", "Java", 33, 0, 9, 16, 58
"c:\Users\zipasink\OneDrive\PhD\research\research-workspace\interactive-auto-mapping-tool\test-systems\Jabref\sources\3.7\src\main\java\net\sf\jabref\gui\undo\UndoableRemoveEntry.java", "Java", 41, 0, 8, 12, 61
"c:\Users\zipasink\OneDrive\PhD\research\research-workspace\interactive-auto-mapping-tool\test-systems\Jabref\sources\3.7\src\main\java\net\sf\jabref\gui\undo\UndoableRemoveString.java", "Java", 41, 0, 2, 15, 58
"c:\Users\zipasink\OneDrive\PhD\research\research-workspace\interactive-auto-mapping-tool\test-systems\Jabref\sources\3.7\src\main\java\net\sf\jabref\gui\undo\UndoableStringChange.java", "Java", 49, 0, 2, 17, 68
"c:\Users\zipasink\OneDrive\PhD\research\research-workspace\interactive-auto-mapping-tool\test-systems\Jabref\sources\3.7\src\main\java\net\sf\jabref\gui\util\GUIUtil.java", "Java", 16, 0, 17, 7, 40
"c:\Users\zipasink\OneDrive\PhD\research\research-workspace\interactive-auto-mapping-tool\test-systems\Jabref\sources\3.7\src\main\java\net\sf\jabref\gui\util\WindowLocation.java", "Java", 122, 0, 14, 28, 164
"c:\Users\zipasink\OneDrive\PhD\research\research-workspace\interactive-auto-mapping-tool\test-systems\Jabref\sources\3.7\src\main\java\net\sf\jabref\gui\util\comparator\FirstColumnComparator.java", "Java", 25, 0, 0, 11, 36
"c:\Users\zipasink\OneDrive\PhD\research\research-workspace\interactive-auto-mapping-tool\test-systems\Jabref\sources\3.7\src\main\java\net\sf\jabref\gui\util\comparator\IconComparator.java", "Java", 35, 0, 6, 10, 51
"c:\Users\zipasink\OneDrive\PhD\research\research-workspace\interactive-auto-mapping-tool\test-systems\Jabref\sources\3.7\src\main\java\net\sf\jabref\gui\util\comparator\IsMarkedComparator.java", "Java", 11, 0, 0, 7, 18
"c:\Users\zipasink\OneDrive\PhD\research\research-workspace\interactive-auto-mapping-tool\test-systems\Jabref\sources\3.7\src\main\java\net\sf\jabref\gui\util\comparator\RankingFieldComparator.java", "Java", 30, 0, 8, 6, 44
"c:\Users\zipasink\OneDrive\PhD\research\research-workspace\interactive-auto-mapping-tool\test-systems\Jabref\sources\3.7\src\main\java\net\sf\jabref\gui\util\component\CheckBoxMessage.java", "Java", 29, 0, 0, 9, 38
"c:\Users\zipasink\OneDrive\PhD\research\research-workspace\interactive-auto-mapping-tool\test-systems\Jabref\sources\3.7\src\main\java\net\sf\jabref\gui\util\component\DiffHighlightingTextPane.java", "Java", 21, 0, 0, 8, 29
"c:\Users\zipasink\OneDrive\PhD\research\research-workspace\interactive-auto-mapping-tool\test-systems\Jabref\sources\3.7\src\main\java\net\sf\jabref\gui\util\component\JTextAreaWithPlaceholder.java", "Java", 62, 0, 16, 13, 91
"c:\Users\zipasink\OneDrive\PhD\research\research-workspace\interactive-auto-mapping-tool\test-systems\Jabref\sources\3.7\src\main\java\net\sf\jabref\gui\util\component\JTextFieldWithPlaceholder.java", "Java", 61, 0, 18, 12, 91
"c:\Users\zipasink\OneDrive\PhD\research\research-workspace\interactive-auto-mapping-tool\test-systems\Jabref\sources\3.7\src\main\java\net\sf\jabref\gui\util\component\OverlayPanel.java", "Java", 38, 0, 3, 15, 56
"c:\Users\zipasink\OneDrive\PhD\research\research-workspace\interactive-auto-mapping-tool\test-systems\Jabref\sources\3.7\src\main\java\net\sf\jabref\gui\util\component\VerticalLabelUI.java", "Java", 89, 0, 56, 20, 165
"c:\Users\zipasink\OneDrive\PhD\research\research-workspace\interactive-auto-mapping-tool\test-systems\Jabref\sources\3.7\src\main\java\net\sf\jabref\gui\worker\AbstractWorker.java", "Java", 21, 0, 23, 11, 55
"c:\Users\zipasink\OneDrive\PhD\research\research-workspace\interactive-auto-mapping-tool\test-systems\Jabref\sources\3.7\src\main\java\net\sf\jabref\gui\worker\CallBack.java", "Java", 5, 0, 3, 4, 12
"c:\Users\zipasink\OneDrive\PhD\research\research-workspace\interactive-auto-mapping-tool\test-systems\Jabref\sources\3.7\src\main\java\net\sf\jabref\gui\worker\CitationStyleWorker.java", "Java", 57, 0, 3, 18, 78
"c:\Users\zipasink\OneDrive\PhD\research\research-workspace\interactive-auto-mapping-tool\test-systems\Jabref\sources\3.7\src\main\java\net\sf\jabref\gui\worker\MarkEntriesAction.java", "Java", 78, 0, 5, 16, 99
"c:\Users\zipasink\OneDrive\PhD\research\research-workspace\interactive-auto-mapping-tool\test-systems\Jabref\sources\3.7\src\main\java\net\sf\jabref\gui\worker\SendAsEMailAction.java", "Java", 97, 0, 13, 23, 133
"c:\Users\zipasink\OneDrive\PhD\research\research-workspace\interactive-auto-mapping-tool\test-systems\Jabref\sources\3.7\src\main\java\net\sf\jabref\gui\worker\VersionWorker.java", "Java", 74, 0, 21, 24, 119
"c:\Users\zipasink\OneDrive\PhD\research\research-workspace\interactive-auto-mapping-tool\test-systems\Jabref\sources\3.7\src\main\java\net\sf\jabref\gui\worker\Worker.java", "Java", 3, 0, 4, 2, 9
"c:\Users\zipasink\OneDrive\PhD\research\research-workspace\interactive-auto-mapping-tool\test-systems\Jabref\sources\3.7\src\main\java\net\sf\jabref\logic\CustomEntryTypesManager.java", "Java", 34, 0, 13, 8, 55
"c:\Users\zipasink\OneDrive\PhD\research\research-workspace\interactive-auto-mapping-tool\test-systems\Jabref\sources\3.7\src\main\java\net\sf\jabref\logic\TypedBibEntry.java", "Java", 64, 0, 13, 16, 93
"c:\Users\zipasink\OneDrive\PhD\research\research-workspace\interactive-auto-mapping-tool\test-systems\Jabref\sources\3.7\src\main\java\net\sf\jabref\logic\autocompleter\AbstractAutoCompleter.java", "Java", 80, 0, 36, 23, 139
"c:\Users\zipasink\OneDrive\PhD\research\research-workspace\interactive-auto-mapping-tool\test-systems\Jabref\sources\3.7\src\main\java\net\sf\jabref\logic\autocompleter\AutoCompleteFirstNameMode.java", "Java", 6, 0, 0, 3, 9
"c:\Users\zipasink\OneDrive\PhD\research\research-workspace\interactive-auto-mapping-tool\test-systems\Jabref\sources\3.7\src\main\java\net\sf\jabref\logic\autocompleter\AutoCompletePreferences.java", "Java", 64, 0, 7, 20, 91
"c:\Users\zipasink\OneDrive\PhD\research\research-workspace\interactive-auto-mapping-tool\test-systems\Jabref\sources\3.7\src\main\java\net\sf\jabref\logic\autocompleter\AutoCompleter.java", "Java", 11, 0, 37, 10, 58
"c:\Users\zipasink\OneDrive\PhD\research\research-workspace\interactive-auto-mapping-tool\test-systems\Jabref\sources\3.7\src\main\java\net\sf\jabref\logic\autocompleter\AutoCompleterFactory.java", "Java", 30, 0, 5, 11, 46
"c:\Users\zipasink\OneDrive\PhD\research\research-workspace\interactive-auto-mapping-tool\test-systems\Jabref\sources\3.7\src\main\java\net\sf\jabref\logic\autocompleter\AutoCompleters.java", "Java", 24, 0, 6, 10, 40
"c:\Users\zipasink\OneDrive\PhD\research\research-workspace\interactive-auto-mapping-tool\test-systems\Jabref\sources\3.7\src\main\java\net\sf\jabref\logic\autocompleter\BibtexKeyAutoCompleter.java", "Java", 22, 0, 9, 8, 39
"c:\Users\zipasink\OneDrive\PhD\research\research-workspace\interactive-auto-mapping-tool\test-systems\Jabref\sources\3.7\src\main\java\net\sf\jabref\logic\autocompleter\ContentAutoCompleters.java", "Java", 20, 0, 0, 8, 28
"c:\Users\zipasink\OneDrive\PhD\research\research-workspace\interactive-auto-mapping-tool\test-systems\Jabref\sources\3.7\src\main\java\net\sf\jabref\logic\autocompleter\DefaultAutoCompleter.java", "Java", 28, 0, 13, 11, 52
"c:\Users\zipasink\OneDrive\PhD\research\research-workspace\interactive-auto-mapping-tool\test-systems\Jabref\sources\3.7\src\main\java\net\sf\jabref\logic\autocompleter\EntireFieldAutoCompleter.java", "Java", 21, 0, 13, 10, 44
"c:\Users\zipasink\OneDrive\PhD\research\research-workspace\interactive-auto-mapping-tool\test-systems\Jabref\sources\3.7\src\main\java\net\sf\jabref\logic\autocompleter\JournalAutoCompleter.java", "Java", 27, 0, 1, 10, 38
"c:\Users\zipasink\OneDrive\PhD\research\research-workspace\interactive-auto-mapping-tool\test-systems\Jabref\sources\3.7\src\main\java\net\sf\jabref\logic\autocompleter\NameFieldAutoCompleter.java", "Java", 125, 0, 29, 19, 173
"c:\Users\zipasink\OneDrive\PhD\research\research-workspace\interactive-auto-mapping-tool\test-systems\Jabref\sources\3.7\src\main\java\net\sf\jabref\logic\autosaveandbackup\AutosaveManager.java", "Java", 65, 0, 14, 16, 95
"c:\Users\zipasink\OneDrive\PhD\research\research-workspace\interactive-auto-mapping-tool\test-systems\Jabref\sources\3.7\src\main\java\net\sf\jabref\logic\autosaveandbackup\BackupManager.java", "Java", 115, 0, 30, 25, 170
"c:\Users\zipasink\OneDrive\PhD\research\research-workspace\interactive-auto-mapping-tool\test-systems\Jabref\sources\3.7\src\main\java\net\sf\jabref\logic\auxparser\AuxParser.java", "Java", 113, 0, 36, 30, 179
"c:\Users\zipasink\OneDrive\PhD\research\research-workspace\interactive-auto-mapping-tool\test-systems\Jabref\sources\3.7\src\main\java\net\sf\jabref\logic\auxparser\AuxParserResult.java", "Java", 63, 0, 11, 19, 93
"c:\Users\zipasink\OneDrive\PhD\research\research-workspace\interactive-auto-mapping-tool\test-systems\Jabref\sources\3.7\src\main\java\net\sf\jabref\logic\bibtex\BibEntryWriter.java", "Java", 116, 0, 47, 26, 189
"c:\Users\zipasink\OneDrive\PhD\research\research-workspace\interactive-auto-mapping-tool\test-systems\Jabref\sources\3.7\src\main\java\net\sf\jabref\logic\bibtex\FieldContentParser.java", "Java", 28, 0, 16, 13, 57
"c:\Users\zipasink\OneDrive\PhD\research\research-workspace\interactive-auto-mapping-tool\test-systems\Jabref\sources\3.7\src\main\java\net\sf\jabref\logic\bibtex\FieldContentParserPreferences.java", "Java", 15, 0, 1, 9, 25
"c:\Users\zipasink\OneDrive\PhD\research\research-workspace\interactive-auto-mapping-tool\test-systems\Jabref\sources\3.7\src\main\java\net\sf\jabref\logic\bibtex\LatexFieldFormatter.java", "Java", 193, 0, 44, 46, 283
"c:\Users\zipasink\OneDrive\PhD\research\research-workspace\interactive-auto-mapping-tool\test-systems\Jabref\sources\3.7\src\main\java\net\sf\jabref\logic\bibtex\LatexFieldFormatterPreferences.java", "Java", 30, 0, 1, 11, 42
"c:\Users\zipasink\OneDrive\PhD\research\research-workspace\interactive-auto-mapping-tool\test-systems\Jabref\sources\3.7\src\main\java\net\sf\jabref\logic\bibtex\comparator\BibtexStringComparator.java", "Java", 36, 0, 12, 19, 67
"c:\Users\zipasink\OneDrive\PhD\research\research-workspace\interactive-auto-mapping-tool\test-systems\Jabref\sources\3.7\src\main\java\net\sf\jabref\logic\bibtex\comparator\CrossRefEntryComparator.java", "Java", 19, 0, 6, 7, 32
"c:\Users\zipasink\OneDrive\PhD\research\research-workspace\interactive-auto-mapping-tool\test-systems\Jabref\sources\3.7\src\main\java\net\sf\jabref\logic\bibtex\comparator\EntryComparator.java", "Java", 98, 0, 17, 19, 134
"c:\Users\zipasink\OneDrive\PhD\research\research-workspace\interactive-auto-mapping-tool\test-systems\Jabref\sources\3.7\src\main\java\net\sf\jabref\logic\bibtex\comparator\FieldComparator.java", "Java", 117, 0, 19, 21, 157
"c:\Users\zipasink\OneDrive\PhD\research\research-workspace\interactive-auto-mapping-tool\test-systems\Jabref\sources\3.7\src\main\java\net\sf\jabref\logic\bibtex\comparator\FieldComparatorStack.java", "Java", 19, 0, 5, 7, 31
"c:\Users\zipasink\OneDrive\PhD\research\research-workspace\interactive-auto-mapping-tool\test-systems\Jabref\sources\3.7\src\main\java\net\sf\jabref\logic\bibtex\comparator\IdComparator.java", "Java", 9, 0, 5, 5, 19
"c:\Users\zipasink\OneDrive\PhD\research\research-workspace\interactive-auto-mapping-tool\test-systems\Jabref\sources\3.7\src\main\java\net\sf\jabref\logic\bibtexkeypattern\BibtexKeyPatternPreferences.java", "Java", 43, 0, 0, 12, 55
"c:\Users\zipasink\OneDrive\PhD\research\research-workspace\interactive-auto-mapping-tool\test-systems\Jabref\sources\3.7\src\main\java\net\sf\jabref\logic\bibtexkeypattern\BibtexKeyPatternUtil.java", "Java", 777, 0, 424, 107, 1308
"c:\Users\zipasink\OneDrive\PhD\research\research-workspace\interactive-auto-mapping-tool\test-systems\Jabref\sources\3.7\src\main\java\net\sf\jabref\logic\bst\BibtexCaseChanger.java", "Java", 208, 0, 64, 34, 306
"c:\Users\zipasink\OneDrive\PhD\research\research-workspace\interactive-auto-mapping-tool\test-systems\Jabref\sources\3.7\src\main\java\net\sf\jabref\logic\bst\BibtexNameFormatter.java", "Java", 236, 0, 43, 37, 316
"c:\Users\zipasink\OneDrive\PhD\research\research-workspace\interactive-auto-mapping-tool\test-systems\Jabref\sources\3.7\src\main\java\net\sf\jabref\logic\bst\BibtexPurify.java", "Java", 54, 0, 17, 9, 80
"c:\Users\zipasink\OneDrive\PhD\research\research-workspace\interactive-auto-mapping-tool\test-systems\Jabref\sources\3.7\src\main\java\net\sf\jabref\logic\bst\BibtexTextPrefix.java", "Java", 46, 0, 21, 9, 76
"c:\Users\zipasink\OneDrive\PhD\research\research-workspace\interactive-auto-mapping-tool\test-systems\Jabref\sources\3.7\src\main\java\net\sf\jabref\logic\bst\BibtexWidth.java", "Java", 192, 0, 40, 18, 250
"c:\Users\zipasink\OneDrive\PhD\research\research-workspace\interactive-auto-mapping-tool\test-systems\Jabref\sources\3.7\src\main\java\net\sf\jabref\logic\bst\ChangeCaseFunction.java", "Java", 29, 0, 24, 14, 67
"c:\Users\zipasink\OneDrive\PhD\research\research-workspace\interactive-auto-mapping-tool\test-systems\Jabref\sources\3.7\src\main\java\net\sf\jabref\logic\bst\FormatNameFunction.java", "Java", 39, 0, 17, 13, 69
"c:\Users\zipasink\OneDrive\PhD\research\research-workspace\interactive-auto-mapping-tool\test-systems\Jabref\sources\3.7\src\main\java\net\sf\jabref\logic\bst\PurifyFunction.java", "Java", 24, 0, 10, 11, 45
"c:\Users\zipasink\OneDrive\PhD\research\research-workspace\interactive-auto-mapping-tool\test-systems\Jabref\sources\3.7\src\main\java\net\sf\jabref\logic\bst\TextPrefixFunction.java", "Java", 30, 0, 15, 12, 57
"c:\Users\zipasink\OneDrive\PhD\research\research-workspace\interactive-auto-mapping-tool\test-systems\Jabref\sources\3.7\src\main\java\net\sf\jabref\logic\bst\VM.java", "Java", 745, 0, 271, 233, 1249
"c:\Users\zipasink\OneDrive\PhD\research\research-workspace\interactive-auto-mapping-tool\test-systems\Jabref\sources\3.7\src\main\java\net\sf\jabref\logic\bst\VMException.java", "Java", 6, 0, 0, 4, 10
"c:\Users\zipasink\OneDrive\PhD\research\research-workspace\interactive-auto-mapping-tool\test-systems\Jabref\sources\3.7\src\main\java\net\sf\jabref\logic\bst\Warn.java", "Java", 5, 0, 0, 3, 8
"c:\Users\zipasink\OneDrive\PhD\research\research-workspace\interactive-auto-mapping-tool\test-systems\Jabref\sources\3.7\src\main\java\net\sf\jabref\logic\bst\WidthFunction.java", "Java", 24, 0, 10, 11, 45
"c:\Users\zipasink\OneDrive\PhD\research\research-workspace\interactive-auto-mapping-tool\test-systems\Jabref\sources\3.7\src\main\java\net\sf\jabref\logic\citationstyle\CitationStyle.java", "Java", 133, 0, 19, 29, 181
"c:\Users\zipasink\OneDrive\PhD\research\research-workspace\interactive-auto-mapping-tool\test-systems\Jabref\sources\3.7\src\main\java\net\sf\jabref\logic\citationstyle\CitationStyleCache.java", "Java", 48, 0, 13, 17, 78
"c:\Users\zipasink\OneDrive\PhD\research\research-workspace\interactive-auto-mapping-tool\test-systems\Jabref\sources\3.7\src\main\java\net\sf\jabref\logic\citationstyle\CitationStyleGenerator.java", "Java", 52, 0, 16, 13, 81
"c:\Users\zipasink\OneDrive\PhD\research\research-workspace\interactive-auto-mapping-tool\test-systems\Jabref\sources\3.7\src\main\java\net\sf\jabref\logic\citationstyle\CitationStyleOutputFormat.java", "Java", 19, 0, 0, 9, 28
"c:\Users\zipasink\OneDrive\PhD\research\research-workspace\interactive-auto-mapping-tool\test-systems\Jabref\sources\3.7\src\main\java\net\sf\jabref\logic\cleanup\BiblatexCleanup.java", "Java", 43, 0, 5, 9, 57
"c:\Users\zipasink\OneDrive\PhD\research\research-workspace\interactive-auto-mapping-tool\test-systems\Jabref\sources\3.7\src\main\java\net\sf\jabref\logic\cleanup\CleanupPreferences.java", "Java", 23, 0, 0, 8, 31
"c:\Users\zipasink\OneDrive\PhD\research\research-workspace\interactive-auto-mapping-tool\test-systems\Jabref\sources\3.7\src\main\java\net\sf\jabref\logic\cleanup\CleanupPreset.java", "Java", 116, 0, 9, 30, 155
"c:\Users\zipasink\OneDrive\PhD\research\research-workspace\interactive-auto-mapping-tool\test-systems\Jabref\sources\3.7\src\main\java\net\sf\jabref\logic\cleanup\CleanupWorker.java", "Java", 70, 0, 0, 16, 86
"c:\Users\zipasink\OneDrive\PhD\research\research-workspace\interactive-auto-mapping-tool\test-systems\Jabref\sources\3.7\src\main\java\net\sf\jabref\logic\cleanup\Cleanups.java", "Java", 106, 0, 8, 27, 141
"c:\Users\zipasink\OneDrive\PhD\research\research-workspace\interactive-auto-mapping-tool\test-systems\Jabref\sources\3.7\src\main\java\net\sf\jabref\logic\cleanup\DoiCleanup.java", "Java", 52, 0, 10, 18, 80
"c:\Users\zipasink\OneDrive\PhD\research\research-workspace\interactive-auto-mapping-tool\test-systems\Jabref\sources\3.7\src\main\java\net\sf\jabref\logic\cleanup\FileLinksCleanup.java", "Java", 27, 0, 4, 7, 38
"c:\Users\zipasink\OneDrive\PhD\research\research-workspace\interactive-auto-mapping-tool\test-systems\Jabref\sources\3.7\src\main\java\net\sf\jabref\logic\cleanup\ISSNCleanup.java", "Java", 26, 0, 0, 8, 34
"c:\Users\zipasink\OneDrive\PhD\research\research-workspace\interactive-auto-mapping-tool\test-systems\Jabref\sources\3.7\src\main\java\net\sf\jabref\logic\cleanup\MoveFieldCleanup.java", "Java", 22, 0, 3, 8, 33
"c:\Users\zipasink\OneDrive\PhD\research\research-workspace\interactive-auto-mapping-tool\test-systems\Jabref\sources\3.7\src\main\java\net\sf\jabref\logic\cleanup\MoveFilesCleanup.java", "Java", 69, 0, 1, 17, 87
"c:\Users\zipasink\OneDrive\PhD\research\research-workspace\interactive-auto-mapping-tool\test-systems\Jabref\sources\3.7\src\main\java\net\sf\jabref\logic\cleanup\RelativePathsCleanup.java", "Java", 51, 0, 0, 13, 64
"c:\Users\zipasink\OneDrive\PhD\research\research-workspace\interactive-auto-mapping-tool\test-systems\Jabref\sources\3.7\src\main\java\net\sf\jabref\logic\cleanup\RenamePdfCleanup.java", "Java", 94, 0, 14, 21, 129
"c:\Users\zipasink\OneDrive\PhD\research\research-workspace\interactive-auto-mapping-tool\test-systems\Jabref\sources\3.7\src\main\java\net\sf\jabref\logic\cleanup\UpgradePdfPsToFileCleanup.java", "Java", 44, 0, 5, 13, 62
"c:\Users\zipasink\OneDrive\PhD\research\research-workspace\interactive-auto-mapping-tool\test-systems\Jabref\sources\3.7\src\main\java\net\sf\jabref\logic\error\StreamEavesdropper.java", "Java", 33, 0, 5, 13, 51
"c:\Users\zipasink\OneDrive\PhD\research\research-workspace\interactive-auto-mapping-tool\test-systems\Jabref\sources\3.7\src\main\java\net\sf\jabref\logic\error\TeeStream.java", "Java", 22, 0, 6, 7, 35
"c:\Users\zipasink\OneDrive\PhD\research\research-workspace\interactive-auto-mapping-tool\test-systems\Jabref\sources\3.7\src\main\java\net\sf\jabref\logic\exporter\BibDatabaseWriter.java", "Java", 211, 0, 51, 63, 325
"c:\Users\zipasink\OneDrive\PhD\research\research-workspace\interactive-auto-mapping-tool\test-systems\Jabref\sources\3.7\src\main\java\net\sf\jabref\logic\exporter\BibTeXMLExportFormat.java", "Java", 198, 0, 24, 25, 247
"c:\Users\zipasink\OneDrive\PhD\research\research-workspace\interactive-auto-mapping-tool\test-systems\Jabref\sources\3.7\src\main\java\net\sf\jabref\logic\exporter\BibtexDatabaseWriter.java", "Java", 152, 0, 3, 23, 178
"c:\Users\zipasink\OneDrive\PhD\research\research-workspace\interactive-auto-mapping-tool\test-systems\Jabref\sources\3.7\src\main\java\net\sf\jabref\logic\exporter\CustomExportList.java", "Java", 106, 0, 7, 21, 134
"c:\Users\zipasink\OneDrive\PhD\research\research-workspace\interactive-auto-mapping-tool\test-systems\Jabref\sources\3.7\src\main\java\net\sf\jabref\logic\exporter\ExportComparator.java", "Java", 9, 0, 0, 5, 14
"c:\Users\zipasink\OneDrive\PhD\research\research-workspace\interactive-auto-mapping-tool\test-systems\Jabref\sources\3.7\src\main\java\net\sf\jabref\logic\exporter\ExportFormat.java", "Java", 221, 0, 119, 42, 382
"c:\Users\zipasink\OneDrive\PhD\research\research-workspace\interactive-auto-mapping-tool\test-systems\Jabref\sources\3.7\src\main\java\net\sf\jabref\logic\exporter\ExportFormats.java", "Java", 78, 0, 26, 19, 123
"c:\Users\zipasink\OneDrive\PhD\research\research-workspace\interactive-auto-mapping-tool\test-systems\Jabref\sources\3.7\src\main\java\net\sf\jabref\logic\exporter\FileSaveSession.java", "Java", 92, 0, 19, 17, 128
"c:\Users\zipasink\OneDrive\PhD\research\research-workspace\interactive-auto-mapping-tool\test-systems\Jabref\sources\3.7\src\main\java\net\sf\jabref\logic\exporter\IExportFormat.java", "Java", 15, 0, 31, 10, 56
"c:\Users\zipasink\OneDrive\PhD\research\research-workspace\interactive-auto-mapping-tool\test-systems\Jabref\sources\3.7\src\main\java\net\sf\jabref\logic\exporter\MSBibExportFormat.java", "Java", 47, 0, 4, 9, 60
"c:\Users\zipasink\OneDrive\PhD\research\research-workspace\interactive-auto-mapping-tool\test-systems\Jabref\sources\3.7\src\main\java\net\sf\jabref\logic\exporter\MetaDataSerializer.java", "Java", 85, 0, 8, 15, 108
"c:\Users\zipasink\OneDrive\PhD\research\research-workspace\interactive-auto-mapping-tool\test-systems\Jabref\sources\3.7\src\main\java\net\sf\jabref\logic\exporter\ModsExportFormat.java", "Java", 384, 0, 12, 48, 444
"c:\Users\zipasink\OneDrive\PhD\research\research-workspace\interactive-auto-mapping-tool\test-systems\Jabref\sources\3.7\src\main\java\net\sf\jabref\logic\exporter\OOCalcDatabase.java", "Java", 179, 0, 11, 19, 209
"c:\Users\zipasink\OneDrive\PhD\research\research-workspace\interactive-auto-mapping-tool\test-systems\Jabref\sources\3.7\src\main\java\net\sf\jabref\logic\exporter\OpenDocumentRepresentation.java", "Java", 184, 0, 10, 21, 215
"c:\Users\zipasink\OneDrive\PhD\research\research-workspace\interactive-auto-mapping-tool\test-systems\Jabref\sources\3.7\src\main\java\net\sf\jabref\logic\exporter\OpenDocumentSpreadsheetCreator.java", "Java", 116, 0, 13, 24, 153
"c:\Users\zipasink\OneDrive\PhD\research\research-workspace\interactive-auto-mapping-tool\test-systems\Jabref\sources\3.7\src\main\java\net\sf\jabref\logic\exporter\OpenOfficeDocumentCreator.java", "Java", 103, 0, 11, 21, 135
"c:\Users\zipasink\OneDrive\PhD\research\research-workspace\interactive-auto-mapping-tool\test-systems\Jabref\sources\3.7\src\main\java\net\sf\jabref\logic\exporter\SaveException.java", "Java", 59, 0, 4, 16, 79
"c:\Users\zipasink\OneDrive\PhD\research\research-workspace\interactive-auto-mapping-tool\test-systems\Jabref\sources\3.7\src\main\java\net\sf\jabref\logic\exporter\SavePreferences.java", "Java", 128, 0, 1, 26, 155
"c:\Users\zipasink\OneDrive\PhD\research\research-workspace\interactive-auto-mapping-tool\test-systems\Jabref\sources\3.7\src\main\java\net\sf\jabref\logic\exporter\SaveSession.java", "Java", 39, 0, 0, 14, 53
"c:\Users\zipasink\OneDrive\PhD\research\research-workspace\interactive-auto-mapping-tool\test-systems\Jabref\sources\3.7\src\main\java\net\sf\jabref\logic\exporter\StringSaveSession.java", "Java", 44, 0, 0, 11, 55
"c:\Users\zipasink\OneDrive\PhD\research\research-workspace\interactive-auto-mapping-tool\test-systems\Jabref\sources\3.7\src\main\java\net\sf\jabref\logic\exporter\VerifyingWriter.java", "Java", 39, 0, 5, 9, 53
"c:\Users\zipasink\OneDrive\PhD\research\research-workspace\interactive-auto-mapping-tool\test-systems\Jabref\sources\3.7\src\main\java\net\sf\jabref\logic\formatter\Formatters.java", "Java", 76, 0, 0, 10, 86
"c:\Users\zipasink\OneDrive\PhD\research\research-workspace\interactive-auto-mapping-tool\test-systems\Jabref\sources\3.7\src\main\java\net\sf\jabref\logic\formatter\IdentityFormatter.java", "Java", 35, 0, 3, 12, 50
"c:\Users\zipasink\OneDrive\PhD\research\research-workspace\interactive-auto-mapping-tool\test-systems\Jabref\sources\3.7\src\main\java\net\sf\jabref\logic\formatter\bibtexfields\ClearFormatter.java", "Java", 27, 0, 0, 10, 37
"c:\Users\zipasink\OneDrive\PhD\research\research-workspace\interactive-auto-mapping-tool\test-systems\Jabref\sources\3.7\src\main\java\net\sf\jabref\logic\formatter\bibtexfields\HtmlToLatexFormatter.java", "Java", 101, 0, 11, 27, 139
"c:\Users\zipasink\OneDrive\PhD\research\research-workspace\interactive-auto-mapping-tool\test-systems\Jabref\sources\3.7\src\main\java\net\sf\jabref\logic\formatter\bibtexfields\HtmlToUnicodeFormatter.java", "Java", 27, 0, 1, 9, 37
"c:\Users\zipasink\OneDrive\PhD\research\research-workspace\interactive-auto-mapping-tool\test-systems\Jabref\sources\3.7\src\main\java\net\sf\jabref\logic\formatter\bibtexfields\LatexCleanupFormatter.java", "Java", 36, 0, 3, 10, 49
"c:\Users\zipasink\OneDrive\PhD\research\research-workspace\interactive-auto-mapping-tool\test-systems\Jabref\sources\3.7\src\main\java\net\sf\jabref\logic\formatter\bibtexfields\NormalizeDateFormatter.java", "Java", 55, 0, 21, 13, 89
"c:\Users\zipasink\OneDrive\PhD\research\research-workspace\interactive-auto-mapping-tool\test-systems\Jabref\sources\3.7\src\main\java\net\sf\jabref\logic\formatter\bibtexfields\NormalizeMonthFormatter.java", "Java", 33, 0, 0, 10, 43
"c:\Users\zipasink\OneDrive\PhD\research\research-workspace\interactive-auto-mapping-tool\test-systems\Jabref\sources\3.7\src\main\java\net\sf\jabref\logic\formatter\bibtexfields\NormalizeNamesFormatter.java", "Java", 29, 0, 3, 10, 42
"c:\Users\zipasink\OneDrive\PhD\research\research-workspace\interactive-auto-mapping-tool\test-systems\Jabref\sources\3.7\src\main\java\net\sf\jabref\logic\formatter\bibtexfields\NormalizePagesFormatter.java", "Java", 55, 0, 29, 17, 101
"c:\Users\zipasink\OneDrive\PhD\research\research-workspace\interactive-auto-mapping-tool\test-systems\Jabref\sources\3.7\src\main\java\net\sf\jabref\logic\formatter\bibtexfields\OrdinalsToSuperscriptFormatter.java", "Java", 36, 0, 15, 15, 66
"c:\Users\zipasink\OneDrive\PhD\research\research-workspace\interactive-auto-mapping-tool\test-systems\Jabref\sources\3.7\src\main\java\net\sf\jabref\logic\formatter\bibtexfields\RemoveBracesFormatter.java", "Java", 52, 0, 13, 12, 77
"c:\Users\zipasink\OneDrive\PhD\research\research-workspace\interactive-auto-mapping-tool\test-systems\Jabref\sources\3.7\src\main\java\net\sf\jabref\logic\formatter\bibtexfields\UnicodeToLatexFormatter.java", "Java", 67, 0, 3, 15, 85
"c:\Users\zipasink\OneDrive\PhD\research\research-workspace\interactive-auto-mapping-tool\test-systems\Jabref\sources\3.7\src\main\java\net\sf\jabref\logic\formatter\bibtexfields\UnitsToLatexFormatter.java", "Java", 118, 0, 4, 21, 143
"c:\Users\zipasink\OneDrive\PhD\research\research-workspace\interactive-auto-mapping-tool\test-systems\Jabref\sources\3.7\src\main\java\net\sf\jabref\logic\formatter\casechanger\CapitalizeFormatter.java", "Java", 28, 0, 3, 11, 42
"c:\Users\zipasink\OneDrive\PhD\research\research-workspace\interactive-auto-mapping-tool\test-systems\Jabref\sources\3.7\src\main\java\net\sf\jabref\logic\formatter\casechanger\LowerCaseFormatter.java", "Java", 35, 0, 3, 13, 51
"c:\Users\zipasink\OneDrive\PhD\research\research-workspace\interactive-auto-mapping-tool\test-systems\Jabref\sources\3.7\src\main\java\net\sf\jabref\logic\formatter\casechanger\ProtectTermsFormatter.java", "Java", 54, 0, 10, 15, 79
"c:\Users\zipasink\OneDrive\PhD\research\research-workspace\interactive-auto-mapping-tool\test-systems\Jabref\sources\3.7\src\main\java\net\sf\jabref\logic\formatter\casechanger\SentenceCaseFormatter.java", "Java", 28, 0, 3, 11, 42
"c:\Users\zipasink\OneDrive\PhD\research\research-workspace\interactive-auto-mapping-tool\test-systems\Jabref\sources\3.7\src\main\java\net\sf\jabref\logic\formatter\casechanger\Title.java", "Java", 31, 0, 3, 10, 44
"c:\Users\zipasink\OneDrive\PhD\research\research-workspace\interactive-auto-mapping-tool\test-systems\Jabref\sources\3.7\src\main\java\net\sf\jabref\logic\formatter\casechanger\TitleCaseFormatter.java", "Java", 36, 0, 5, 13, 54
"c:\Users\zipasink\OneDrive\PhD\research\research-workspace\interactive-auto-mapping-tool\test-systems\Jabref\sources\3.7\src\main\java\net\sf\jabref\logic\formatter\casechanger\TitleParser.java", "Java", 56, 0, 3, 21, 80
"c:\Users\zipasink\OneDrive\PhD\research\research-workspace\interactive-auto-mapping-tool\test-systems\Jabref\sources\3.7\src\main\java\net\sf\jabref\logic\formatter\casechanger\UpperCaseFormatter.java", "Java", 28, 0, 3, 11, 42
"c:\Users\zipasink\OneDrive\PhD\research\research-workspace\interactive-auto-mapping-tool\test-systems\Jabref\sources\3.7\src\main\java\net\sf\jabref\logic\formatter\casechanger\Word.java", "Java", 66, 0, 16, 20, 102
"c:\Users\zipasink\OneDrive\PhD\research\research-workspace\interactive-auto-mapping-tool\test-systems\Jabref\sources\3.7\src\main\java\net\sf\jabref\logic\formatter\minifier\MinifyNameListFormatter.java", "Java", 47, 0, 17, 17, 81
"c:\Users\zipasink\OneDrive\PhD\research\research-workspace\interactive-auto-mapping-tool\test-systems\Jabref\sources\3.7\src\main\java\net\sf\jabref\logic\groups\GroupDescriptions.java", "Java", 109, 0, 0, 12, 121
"c:\Users\zipasink\OneDrive\PhD\research\research-workspace\interactive-auto-mapping-tool\test-systems\Jabref\sources\3.7\src\main\java\net\sf\jabref\logic\groups\GroupsParser.java", "Java", 122, 0, 34, 15, 171
"c:\Users\zipasink\OneDrive\PhD\research\research-workspace\interactive-auto-mapping-tool\test-systems\Jabref\sources\3.7\src\main\java\net\sf\jabref\logic\help\HelpFile.java", "Java", 53, 0, 17, 5, 75
"c:\Users\zipasink\OneDrive\PhD\research\research-workspace\interactive-auto-mapping-tool\test-systems\Jabref\sources\3.7\src\main\java\net\sf\jabref\logic\importer\EntryBasedParserFetcher.java", "Java", 32, 0, 29, 11, 72
"c:\Users\zipasink\OneDrive\PhD\research\research-workspace\interactive-auto-mapping-tool\test-systems\Jabref\sources\3.7\src\main\java\net\sf\jabref\logic\importer\FetcherException.java", "Java", 13, 0, 0, 7, 20
"c:\Users\zipasink\OneDrive\PhD\research\research-workspace\interactive-auto-mapping-tool\test-systems\Jabref\sources\3.7\src\main\java\net\sf\jabref\logic\importer\FulltextFetcher.java", "Java", 9, 0, 13, 4, 26
"c:\Users\zipasink\OneDrive\PhD\research\research-workspace\interactive-auto-mapping-tool\test-systems\Jabref\sources\3.7\src\main\java\net\sf\jabref\logic\importer\FulltextFetchers.java", "Java", 53, 0, 7, 12, 72
"c:\Users\zipasink\OneDrive\PhD\research\research-workspace\interactive-auto-mapping-tool\test-systems\Jabref\sources\3.7\src\main\java\net\sf\jabref\logic\importer\IdBasedFetcher.java", "Java", 6, 0, 10, 5, 21
"c:\Users\zipasink\OneDrive\PhD\research\research-workspace\interactive-auto-mapping-tool\test-systems\Jabref\sources\3.7\src\main\java\net\sf\jabref\logic\importer\IdBasedParserFetcher.java", "Java", 50, 0, 29, 16, 95
"c:\Users\zipasink\OneDrive\PhD\research\research-workspace\interactive-auto-mapping-tool\test-systems\Jabref\sources\3.7\src\main\java\net\sf\jabref\logic\importer\ImportException.java", "Java", 13, 0, 0, 7, 20
"c:\Users\zipasink\OneDrive\PhD\research\research-workspace\interactive-auto-mapping-tool\test-systems\Jabref\sources\3.7\src\main\java\net\sf\jabref\logic\importer\ImportFormatPreferences.java", "Java", 48, 0, 6, 13, 67
"c:\Users\zipasink\OneDrive\PhD\research\research-workspace\interactive-auto-mapping-tool\test-systems\Jabref\sources\3.7\src\main\java\net\sf\jabref\logic\importer\ImportFormatReader.java", "Java", 142, 0, 44, 35, 221
"c:\Users\zipasink\OneDrive\PhD\research\research-workspace\interactive-auto-mapping-tool\test-systems\Jabref\sources\3.7\src\main\java\net\sf\jabref\logic\importer\ImportInspector.java", "Java", 6, 0, 26, 5, 37
"c:\Users\zipasink\OneDrive\PhD\research\research-workspace\interactive-auto-mapping-tool\test-systems\Jabref\sources\3.7\src\main\java\net\sf\jabref\logic\importer\Importer.java", "Java", 77, 0, 72, 21, 170
"c:\Users\zipasink\OneDrive\PhD\research\research-workspace\interactive-auto-mapping-tool\test-systems\Jabref\sources\3.7\src\main\java\net\sf\jabref\logic\importer\MimeTypeDetector.java", "Java", 42, 0, 3, 14, 59
"c:\Users\zipasink\OneDrive\PhD\research\research-workspace\interactive-auto-mapping-tool\test-systems\Jabref\sources\3.7\src\main\java\net\sf\jabref\logic\importer\OpenDatabase.java", "Java", 58, 0, 9, 12, 79
"c:\Users\zipasink\OneDrive\PhD\research\research-workspace\interactive-auto-mapping-tool\test-systems\Jabref\sources\3.7\src\main\java\net\sf\jabref\logic\importer\OutputPrinter.java", "Java", 6, 0, 0, 6, 12
"c:\Users\zipasink\OneDrive\PhD\research\research-workspace\interactive-auto-mapping-tool\test-systems\Jabref\sources\3.7\src\main\java\net\sf\jabref\logic\importer\ParseException.java", "Java", 12, 0, 0, 5, 17
"c:\Users\zipasink\OneDrive\PhD\research\research-workspace\interactive-auto-mapping-tool\test-systems\Jabref\sources\3.7\src\main\java\net\sf\jabref\logic\importer\Parser.java", "Java", 7, 0, 3, 5, 15
"c:\Users\zipasink\OneDrive\PhD\research\research-workspace\interactive-auto-mapping-tool\test-systems\Jabref\sources\3.7\src\main\java\net\sf\jabref\logic\importer\ParserResult.java", "Java", 128, 0, 25, 36, 189
"c:\Users\zipasink\OneDrive\PhD\research\research-workspace\interactive-auto-mapping-tool\test-systems\Jabref\sources\3.7\src\main\java\net\sf\jabref\logic\importer\SearchBasedFetcher.java", "Java", 6, 0, 10, 5, 21
"c:\Users\zipasink\OneDrive\PhD\research\research-workspace\interactive-auto-mapping-tool\test-systems\Jabref\sources\3.7\src\main\java\net\sf\jabref\logic\importer\SearchBasedParserFetcher.java", "Java", 35, 0, 29, 12, 76
"c:\Users\zipasink\OneDrive\PhD\research\research-workspace\interactive-auto-mapping-tool\test-systems\Jabref\sources\3.7\src\main\java\net\sf\jabref\logic\importer\WebFetchers.java", "Java", 25, 0, 0, 5, 30
"c:\Users\zipasink\OneDrive\PhD\research\research-workspace\interactive-auto-mapping-tool\test-systems\Jabref\sources\3.7\src\main\java\net\sf\jabref\logic\importer\fetcher\ACS.java", "Java", 34, 0, 15, 10, 59
"c:\Users\zipasink\OneDrive\PhD\research\research-workspace\interactive-auto-mapping-tool\test-systems\Jabref\sources\3.7\src\main\java\net\sf\jabref\logic\importer\fetcher\ArXiv.java", "Java", 244, 0, 65, 47, 356
"c:\Users\zipasink\OneDrive\PhD\research\research-workspace\interactive-auto-mapping-tool\test-systems\Jabref\sources\3.7\src\main\java\net\sf\jabref\logic\importer\fetcher\AstrophysicsDataSystem.java", "Java", 123, 0, 14, 24, 161
"c:\Users\zipasink\OneDrive\PhD\research\research-workspace\interactive-auto-mapping-tool\test-systems\Jabref\sources\3.7\src\main\java\net\sf\jabref\logic\importer\fetcher\BibsonomyScraper.java", "Java", 31, 0, 10, 9, 50
"c:\Users\zipasink\OneDrive\PhD\research\research-workspace\interactive-auto-mapping-tool\test-systems\Jabref\sources\3.7\src\main\java\net\sf\jabref\logic\importer\fetcher\CrossRef.java", "Java", 83, 0, 16, 22, 121
"c:\Users\zipasink\OneDrive\PhD\research\research-workspace\interactive-auto-mapping-tool\test-systems\Jabref\sources\3.7\src\main\java\net\sf\jabref\logic\importer\fetcher\DBLPFetcher.java", "Java", 55, 0, 5, 19, 79
"c:\Users\zipasink\OneDrive\PhD\research\research-workspace\interactive-auto-mapping-tool\test-systems\Jabref\sources\3.7\src\main\java\net\sf\jabref\logic\importer\fetcher\DiVA.java", "Java", 39, 0, 4, 14, 57
"c:\Users\zipasink\OneDrive\PhD\research\research-workspace\interactive-auto-mapping-tool\test-systems\Jabref\sources\3.7\src\main\java\net\sf\jabref\logic\importer\fetcher\DoiFetcher.java", "Java", 49, 0, 2, 13, 64
"c:\Users\zipasink\OneDrive\PhD\research\research-workspace\interactive-auto-mapping-tool\test-systems\Jabref\sources\3.7\src\main\java\net\sf\jabref\logic\importer\fetcher\DoiResolution.java", "Java", 59, 0, 11, 11, 81
"c:\Users\zipasink\OneDrive\PhD\research\research-workspace\interactive-auto-mapping-tool\test-systems\Jabref\sources\3.7\src\main\java\net\sf\jabref\logic\importer\fetcher\GoogleScholar.java", "Java", 146, 0, 13, 28, 187
"c:\Users\zipasink\OneDrive\PhD\research\research-workspace\interactive-auto-mapping-tool\test-systems\Jabref\sources\3.7\src\main\java\net\sf\jabref\logic\importer\fetcher\GvkFetcher.java", "Java", 69, 0, 5, 16, 90
"c:\Users\zipasink\OneDrive\PhD\research\research-workspace\interactive-auto-mapping-tool\test-systems\Jabref\sources\3.7\src\main\java\net\sf\jabref\logic\importer\fetcher\IEEE.java", "Java", 56, 0, 16, 13, 85
"c:\Users\zipasink\OneDrive\PhD\research\research-workspace\interactive-auto-mapping-tool\test-systems\Jabref\sources\3.7\src\main\java\net\sf\jabref\logic\importer\fetcher\IsbnFetcher.java", "Java", 53, 0, 4, 14, 71
"c:\Users\zipasink\OneDrive\PhD\research\research-workspace\interactive-auto-mapping-tool\test-systems\Jabref\sources\3.7\src\main\java\net\sf\jabref\logic\importer\fetcher\MathSciNet.java", "Java", 77, 0, 9, 16, 102
"c:\Users\zipasink\OneDrive\PhD\research\research-workspace\interactive-auto-mapping-tool\test-systems\Jabref\sources\3.7\src\main\java\net\sf\jabref\logic\importer\fetcher\MedlineFetcher.java", "Java", 158, 0, 29, 33, 220
"c:\Users\zipasink\OneDrive\PhD\research\research-workspace\interactive-auto-mapping-tool\test-systems\Jabref\sources\3.7\src\main\java\net\sf\jabref\logic\importer\fetcher\ScienceDirect.java", "Java", 70, 0, 8, 13, 91
"c:\Users\zipasink\OneDrive\PhD\research\research-workspace\interactive-auto-mapping-tool\test-systems\Jabref\sources\3.7\src\main\java\net\sf\jabref\logic\importer\fetcher\SpringerLink.java", "Java", 45, 0, 7, 11, 63
"c:\Users\zipasink\OneDrive\PhD\research\research-workspace\interactive-auto-mapping-tool\test-systems\Jabref\sources\3.7\src\main\java\net\sf\jabref\logic\importer\fetcher\zbMATH.java", "Java", 78, 0, 28, 26, 132
"c:\Users\zipasink\OneDrive\PhD\research\research-workspace\interactive-auto-mapping-tool\test-systems\Jabref\sources\3.7\src\main\java\net\sf\jabref\logic\importer\fileformat\BibTeXMLImporter.java", "Java", 193, 0, 29, 26, 248
"c:\Users\zipasink\OneDrive\PhD\research\research-workspace\interactive-auto-mapping-tool\test-systems\Jabref\sources\3.7\src\main\java\net\sf\jabref\logic\importer\fileformat\BiblioscapeImporter.java", "Java", 244, 0, 22, 19, 285
"c:\Users\zipasink\OneDrive\PhD\research\research-workspace\interactive-auto-mapping-tool\test-systems\Jabref\sources\3.7\src\main\java\net\sf\jabref\logic\importer\fileformat\BibtexImporter.java", "Java", 86, 0, 27, 19, 132
"c:\Users\zipasink\OneDrive\PhD\research\research-workspace\interactive-auto-mapping-tool\test-systems\Jabref\sources\3.7\src\main\java\net\sf\jabref\logic\importer\fileformat\BibtexParser.java", "Java", 664, 0, 158, 154, 976
"c:\Users\zipasink\OneDrive\PhD\research\research-workspace\interactive-auto-mapping-tool\test-systems\Jabref\sources\3.7\src\main\java\net\sf\jabref\logic\importer\fileformat\CopacImporter.java", "Java", 112, 0, 11, 27, 150
"c:\Users\zipasink\OneDrive\PhD\research\research-workspace\interactive-auto-mapping-tool\test-systems\Jabref\sources\3.7\src\main\java\net\sf\jabref\logic\importer\fileformat\CustomImporter.java", "Java", 86, 0, 5, 23, 114
"c:\Users\zipasink\OneDrive\PhD\research\research-workspace\interactive-auto-mapping-tool\test-systems\Jabref\sources\3.7\src\main\java\net\sf\jabref\logic\importer\fileformat\EndnoteImporter.java", "Java", 222, 0, 43, 29, 294
"c:\Users\zipasink\OneDrive\PhD\research\research-workspace\interactive-auto-mapping-tool\test-systems\Jabref\sources\3.7\src\main\java\net\sf\jabref\logic\importer\fileformat\FreeCiteImporter.java", "Java", 182, 0, 29, 30, 241
"c:\Users\zipasink\OneDrive\PhD\research\research-workspace\interactive-auto-mapping-tool\test-systems\Jabref\sources\3.7\src\main\java\net\sf\jabref\logic\importer\fileformat\GvkParser.java", "Java", 356, 0, 68, 69, 493
"c:\Users\zipasink\OneDrive\PhD\research\research-workspace\interactive-auto-mapping-tool\test-systems\Jabref\sources\3.7\src\main\java\net\sf\jabref\logic\importer\fileformat\InspecImporter.java", "Java", 114, 0, 5, 15, 134
"c:\Users\zipasink\OneDrive\PhD\research\research-workspace\interactive-auto-mapping-tool\test-systems\Jabref\sources\3.7\src\main\java\net\sf\jabref\logic\importer\fileformat\IsiImporter.java", "Java", 297, 0, 52, 74, 423
"c:\Users\zipasink\OneDrive\PhD\research\research-workspace\interactive-auto-mapping-tool\test-systems\Jabref\sources\3.7\src\main\java\net\sf\jabref\logic\importer\fileformat\MedlineImporter.java", "Java", 607, 0, 26, 68, 701
"c:\Users\zipasink\OneDrive\PhD\research\research-workspace\interactive-auto-mapping-tool\test-systems\Jabref\sources\3.7\src\main\java\net\sf\jabref\logic\importer\fileformat\MedlinePlainImporter.java", "Java", 344, 0, 20, 43, 407
"c:\Users\zipasink\OneDrive\PhD\research\research-workspace\interactive-auto-mapping-tool\test-systems\Jabref\sources\3.7\src\main\java\net\sf\jabref\logic\importer\fileformat\ModsImporter.java", "Java", 380, 0, 36, 63, 479
"c:\Users\zipasink\OneDrive\PhD\research\research-workspace\interactive-auto-mapping-tool\test-systems\Jabref\sources\3.7\src\main\java\net\sf\jabref\logic\importer\fileformat\MsBibImporter.java", "Java", 44, 0, 11, 14, 69
"c:\Users\zipasink\OneDrive\PhD\research\research-workspace\interactive-auto-mapping-tool\test-systems\Jabref\sources\3.7\src\main\java\net\sf\jabref\logic\importer\fileformat\OvidImporter.java", "Java", 193, 0, 18, 36, 247
"c:\Users\zipasink\OneDrive\PhD\research\research-workspace\interactive-auto-mapping-tool\test-systems\Jabref\sources\3.7\src\main\java\net\sf\jabref\logic\importer\fileformat\PdfContentImporter.java", "Java", 424, 0, 114, 66, 604
"c:\Users\zipasink\OneDrive\PhD\research\research-workspace\interactive-auto-mapping-tool\test-systems\Jabref\sources\3.7\src\main\java\net\sf\jabref\logic\importer\fileformat\PdfXmpImporter.java", "Java", 62, 0, 7, 16, 85
"c:\Users\zipasink\OneDrive\PhD\research\research-workspace\interactive-auto-mapping-tool\test-systems\Jabref\sources\3.7\src\main\java\net\sf\jabref\logic\importer\fileformat\RepecNepImporter.java", "Java", 233, 0, 179, 45, 457
"c:\Users\zipasink\OneDrive\PhD\research\research-workspace\interactive-auto-mapping-tool\test-systems\Jabref\sources\3.7\src\main\java\net\sf\jabref\logic\importer\fileformat\RisImporter.java", "Java", 227, 0, 13, 23, 263
"c:\Users\zipasink\OneDrive\PhD\research\research-workspace\interactive-auto-mapping-tool\test-systems\Jabref\sources\3.7\src\main\java\net\sf\jabref\logic\importer\fileformat\SilverPlatterImporter.java", "Java", 159, 0, 13, 21, 193
"c:\Users\zipasink\OneDrive\PhD\research\research-workspace\interactive-auto-mapping-tool\test-systems\Jabref\sources\3.7\src\main\java\net\sf\jabref\logic\importer\util\INSPIREBibtexFilterReader.java", "Java", 64, 0, 14, 12, 90
"c:\Users\zipasink\OneDrive\PhD\research\research-workspace\interactive-auto-mapping-tool\test-systems\Jabref\sources\3.7\src\main\java\net\sf\jabref\logic\importer\util\JSONEntryParser.java", "Java", 163, 0, 34, 30, 227
"c:\Users\zipasink\OneDrive\PhD\research\research-workspace\interactive-auto-mapping-tool\test-systems\Jabref\sources\3.7\src\main\java\net\sf\jabref\logic\importer\util\MetaDataParser.java", "Java", 120, 0, 19, 18, 157
"c:\Users\zipasink\OneDrive\PhD\research\research-workspace\interactive-auto-mapping-tool\test-systems\Jabref\sources\3.7\src\main\java\net\sf\jabref\logic\importer\util\OAI2Handler.java", "Java", 87, 0, 7, 22, 116
"c:\Users\zipasink\OneDrive\PhD\research\research-workspace\interactive-auto-mapping-tool\test-systems\Jabref\sources\3.7\src\main\java\net\sf\jabref\logic\integrity\ASCIICharacterChecker.java", "Java", 22, 0, 3, 6, 31
"c:\Users\zipasink\OneDrive\PhD\research\research-workspace\interactive-auto-mapping-tool\test-systems\Jabref\sources\3.7\src\main\java\net\sf\jabref\logic\integrity\AbbreviationChecker.java", "Java", 25, 0, 0, 10, 35
"c:\Users\zipasink\OneDrive\PhD\research\research-workspace\interactive-auto-mapping-tool\test-systems\Jabref\sources\3.7\src\main\java\net\sf\jabref\logic\integrity\AuthorNameChecker.java", "Java", 31, 0, 0, 6, 37
"c:\Users\zipasink\OneDrive\PhD\research\research-workspace\interactive-auto-mapping-tool\test-systems\Jabref\sources\3.7\src\main\java\net\sf\jabref\logic\integrity\BibStringChecker.java", "Java", 33, 0, 4, 9, 46
"c:\Users\zipasink\OneDrive\PhD\research\research-workspace\interactive-auto-mapping-tool\test-systems\Jabref\sources\3.7\src\main\java\net\sf\jabref\logic\integrity\BiblatexPagesChecker.java", "Java", 35, 0, 6, 10, 51
"c:\Users\zipasink\OneDrive\PhD\research\research-workspace\interactive-auto-mapping-tool\test-systems\Jabref\sources\3.7\src\main\java\net\sf\jabref\logic\integrity\BibtexkeyChecker.java", "Java", 27, 0, 0, 8, 35
"c:\Users\zipasink\OneDrive\PhD\research\research-workspace\interactive-auto-mapping-tool\test-systems\Jabref\sources\3.7\src\main\java\net\sf\jabref\logic\integrity\BooktitleChecker.java", "Java", 24, 0, 0, 7, 31
"c:\Users\zipasink\OneDrive\PhD\research\research-workspace\interactive-auto-mapping-tool\test-systems\Jabref\sources\3.7\src\main\java\net\sf\jabref\logic\integrity\BracketChecker.java", "Java", 38, 0, 1, 12, 51
"c:\Users\zipasink\OneDrive\PhD\research\research-workspace\interactive-auto-mapping-tool\test-systems\Jabref\sources\3.7\src\main\java\net\sf\jabref\logic\integrity\EditionChecker.java", "Java", 37, 0, 12, 12, 61
"c:\Users\zipasink\OneDrive\PhD\research\research-workspace\interactive-auto-mapping-tool\test-systems\Jabref\sources\3.7\src\main\java\net\sf\jabref\logic\integrity\EntryLinkChecker.java", "Java", 42, 0, 0, 10, 52
"c:\Users\zipasink\OneDrive\PhD\research\research-workspace\interactive-auto-mapping-tool\test-systems\Jabref\sources\3.7\src\main\java\net\sf\jabref\logic\integrity\FileChecker.java", "Java", 41, 0, 0, 11, 52
"c:\Users\zipasink\OneDrive\PhD\research\research-workspace\interactive-auto-mapping-tool\test-systems\Jabref\sources\3.7\src\main\java\net\sf\jabref\logic\integrity\HTMLCharacterChecker.java", "Java", 29, 0, 5, 6, 40
"c:\Users\zipasink\OneDrive\PhD\research\research-workspace\interactive-auto-mapping-tool\test-systems\Jabref\sources\3.7\src\main\java\net\sf\jabref\logic\integrity\HowpublishedChecker.java", "Java", 31, 0, 7, 11, 49
"c:\Users\zipasink\OneDrive\PhD\research\research-workspace\interactive-auto-mapping-tool\test-systems\Jabref\sources\3.7\src\main\java\net\sf\jabref\logic\integrity\ISBNChecker.java", "Java", 26, 0, 1, 12, 39
"c:\Users\zipasink\OneDrive\PhD\research\research-workspace\interactive-auto-mapping-tool\test-systems\Jabref\sources\3.7\src\main\java\net\sf\jabref\logic\integrity\ISSNChecker.java", "Java", 28, 0, 1, 11, 40
"c:\Users\zipasink\OneDrive\PhD\research\research-workspace\interactive-auto-mapping-tool\test-systems\Jabref\sources\3.7\src\main\java\net\sf\jabref\logic\integrity\IntegrityCheck.java", "Java", 66, 0, 1, 17, 84
"c:\Users\zipasink\OneDrive\PhD\research\research-workspace\interactive-auto-mapping-tool\test-systems\Jabref\sources\3.7\src\main\java\net\sf\jabref\logic\integrity\IntegrityMessage.java", "Java", 29, 0, 0, 10, 39
"c:\Users\zipasink\OneDrive\PhD\research\research-workspace\interactive-auto-mapping-tool\test-systems\Jabref\sources\3.7\src\main\java\net\sf\jabref\logic\integrity\MonthChecker.java", "Java", 40, 0, 10, 12, 62
"c:\Users\zipasink\OneDrive\PhD\research\research-workspace\interactive-auto-mapping-tool\test-systems\Jabref\sources\3.7\src\main\java\net\sf\jabref\logic\integrity\NoBibtexFieldChecker.java", "Java", 21, 0, 5, 6, 32
"c:\Users\zipasink\OneDrive\PhD\research\research-workspace\interactive-auto-mapping-tool\test-systems\Jabref\sources\3.7\src\main\java\net\sf\jabref\logic\integrity\NoteChecker.java", "Java", 31, 0, 7, 11, 49
"c:\Users\zipasink\OneDrive\PhD\research\research-workspace\interactive-auto-mapping-tool\test-systems\Jabref\sources\3.7\src\main\java\net\sf\jabref\logic\integrity\PagesChecker.java", "Java", 35, 0, 10, 10, 55
"c:\Users\zipasink\OneDrive\PhD\research\research-workspace\interactive-auto-mapping-tool\test-systems\Jabref\sources\3.7\src\main\java\net\sf\jabref\logic\integrity\TitleChecker.java", "Java", 40, 0, 7, 11, 58
"c:\Users\zipasink\OneDrive\PhD\research\research-workspace\interactive-auto-mapping-tool\test-systems\Jabref\sources\3.7\src\main\java\net\sf\jabref\logic\integrity\TypeChecker.java", "Java", 22, 0, 0, 7, 29
"c:\Users\zipasink\OneDrive\PhD\research\research-workspace\interactive-auto-mapping-tool\test-systems\Jabref\sources\3.7\src\main\java\net\sf\jabref\logic\integrity\UrlChecker.java", "Java", 23, 0, 0, 7, 30
"c:\Users\zipasink\OneDrive\PhD\research\research-workspace\interactive-auto-mapping-tool\test-systems\Jabref\sources\3.7\src\main\java\net\sf\jabref\logic\integrity\YearChecker.java", "Java", 33, 0, 7, 10, 50
"c:\Users\zipasink\OneDrive\PhD\research\research-workspace\interactive-auto-mapping-tool\test-systems\Jabref\sources\3.7\src\main\java\net\sf\jabref\logic\journals\Abbreviation.java", "Java", 57, 0, 0, 15, 72
"c:\Users\zipasink\OneDrive\PhD\research\research-workspace\interactive-auto-mapping-tool\test-systems\Jabref\sources\3.7\src\main\java\net\sf\jabref\logic\journals\AbbreviationParser.java", "Java", 76, 0, 10, 16, 102
"c:\Users\zipasink\OneDrive\PhD\research\research-workspace\interactive-auto-mapping-tool\test-systems\Jabref\sources\3.7\src\main\java\net\sf\jabref\logic\journals\JournalAbbreviationLoader.java", "Java", 78, 0, 9, 21, 108
"c:\Users\zipasink\OneDrive\PhD\research\research-workspace\interactive-auto-mapping-tool\test-systems\Jabref\sources\3.7\src\main\java\net\sf\jabref\logic\journals\JournalAbbreviationPreferences.java", "Java", 28, 0, 0, 10, 38
"c:\Users\zipasink\OneDrive\PhD\research\research-workspace\interactive-auto-mapping-tool\test-systems\Jabref\sources\3.7\src\main\java\net\sf\jabref\logic\journals\JournalAbbreviationRepository.java", "Java", 87, 0, 9, 27, 123
"c:\Users\zipasink\OneDrive\PhD\research\research-workspace\interactive-auto-mapping-tool\test-systems\Jabref\sources\3.7\src\main\java\net\sf\jabref\logic\l10n\EncodingControl.java", "Java", 43, 0, 7, 9, 59
"c:\Users\zipasink\OneDrive\PhD\research\research-workspace\interactive-auto-mapping-tool\test-systems\Jabref\sources\3.7\src\main\java\net\sf\jabref\logic\l10n\Encodings.java", "Java", 16, 0, 0, 5, 21
"c:\Users\zipasink\OneDrive\PhD\research\research-workspace\interactive-auto-mapping-tool\test-systems\Jabref\sources\3.7\src\main\java\net\sf\jabref\logic\l10n\Languages.java", "Java", 43, 0, 1, 10, 54
"c:\Users\zipasink\OneDrive\PhD\research\research-workspace\interactive-auto-mapping-tool\test-systems\Jabref\sources\3.7\src\main\java\net\sf\jabref\logic\l10n\Localization.java", "Java", 66, 0, 10, 18, 94
"c:\Users\zipasink\OneDrive\PhD\research\research-workspace\interactive-auto-mapping-tool\test-systems\Jabref\sources\3.7\src\main\java\net\sf\jabref\logic\l10n\LocalizationKey.java", "Java", 19, 0, 2, 8, 29
"c:\Users\zipasink\OneDrive\PhD\research\research-workspace\interactive-auto-mapping-tool\test-systems\Jabref\sources\3.7\src\main\java\net\sf\jabref\logic\l10n\LocalizationKeyParams.java", "Java", 23, 0, 0, 9, 32
"c:\Users\zipasink\OneDrive\PhD\research\research-workspace\interactive-auto-mapping-tool\test-systems\Jabref\sources\3.7\src\main\java\net\sf\jabref\logic\layout\AbstractParamLayoutFormatter.java", "Java", 40, 0, 11, 6, 57
"c:\Users\zipasink\OneDrive\PhD\research\research-workspace\interactive-auto-mapping-tool\test-systems\Jabref\sources\3.7\src\main\java\net\sf\jabref\logic\layout\Layout.java", "Java", 92, 0, 21, 28, 141
"c:\Users\zipasink\OneDrive\PhD\research\research-workspace\interactive-auto-mapping-tool\test-systems\Jabref\sources\3.7\src\main\java\net\sf\jabref\logic\layout\LayoutEntry.java", "Java", 555, 0, 38, 86, 679
"c:\Users\zipasink\OneDrive\PhD\research\research-workspace\interactive-auto-mapping-tool\test-systems\Jabref\sources\3.7\src\main\java\net\sf\jabref\logic\layout\LayoutFormatter.java", "Java", 5, 0, 24, 3, 32
"c:\Users\zipasink\OneDrive\PhD\research\research-workspace\interactive-auto-mapping-tool\test-systems\Jabref\sources\3.7\src\main\java\net\sf\jabref\logic\layout\LayoutFormatterPreferences.java", "Java", 44, 0, 0, 13, 57
"c:\Users\zipasink\OneDrive\PhD\research\research-workspace\interactive-auto-mapping-tool\test-systems\Jabref\sources\3.7\src\main\java\net\sf\jabref\logic\layout\LayoutHelper.java", "Java", 254, 0, 52, 67, 373
"c:\Users\zipasink\OneDrive\PhD\research\research-workspace\interactive-auto-mapping-tool\test-systems\Jabref\sources\3.7\src\main\java\net\sf\jabref\logic\layout\ParamLayoutFormatter.java", "Java", 4, 0, 13, 4, 21
"c:\Users\zipasink\OneDrive\PhD\research\research-workspace\interactive-auto-mapping-tool\test-systems\Jabref\sources\3.7\src\main\java\net\sf\jabref\logic\layout\StringInt.java", "Java", 9, 0, 17, 6, 32
"c:\Users\zipasink\OneDrive\PhD\research\research-workspace\interactive-auto-mapping-tool\test-systems\Jabref\sources\3.7\src\main\java\net\sf\jabref\logic\layout\format\AuthorAbbreviator.java", "Java", 10, 0, 12, 4, 26
"c:\Users\zipasink\OneDrive\PhD\research\research-workspace\interactive-auto-mapping-tool\test-systems\Jabref\sources\3.7\src\main\java\net\sf\jabref\logic\layout\format\AuthorAndsCommaReplacer.java", "Java", 28, 0, 10, 9, 47
"c:\Users\zipasink\OneDrive\PhD\research\research-workspace\interactive-auto-mapping-tool\test-systems\Jabref\sources\3.7\src\main\java\net\sf\jabref\logic\layout\format\AuthorAndsReplacer.java", "Java", 31, 0, 10, 9, 50
"c:\Users\zipasink\OneDrive\PhD\research\research-workspace\interactive-auto-mapping-tool\test-systems\Jabref\sources\3.7\src\main\java\net\sf\jabref\logic\layout\format\AuthorFirstAbbrLastCommas.java", "Java", 9, 0, 10, 4, 23
"c:\Users\zipasink\OneDrive\PhD\research\research-workspace\interactive-auto-mapping-tool\test-systems\Jabref\sources\3.7\src\main\java\net\sf\jabref\logic\layout\format\AuthorFirstAbbrLastOxfordCommas.java", "Java", 9, 0, 13, 5, 27
"c:\Users\zipasink\OneDrive\PhD\research\research-workspace\interactive-auto-mapping-tool\test-systems\Jabref\sources\3.7\src\main\java\net\sf\jabref\logic\layout\format\AuthorFirstFirst.java", "Java", 9, 0, 4, 4, 17
"c:\Users\zipasink\OneDrive\PhD\research\research-workspace\interactive-auto-mapping-tool\test-systems\Jabref\sources\3.7\src\main\java\net\sf\jabref\logic\layout\format\AuthorFirstFirstCommas.java", "Java", 9, 0, 11, 4, 24
"c:\Users\zipasink\OneDrive\PhD\research\research-workspace\interactive-auto-mapping-tool\test-systems\Jabref\sources\3.7\src\main\java\net\sf\jabref\logic\layout\format\AuthorFirstLastCommas.java", "Java", 9, 0, 12, 5, 26
"c:\Users\zipasink\OneDrive\PhD\research\research-workspace\interactive-auto-mapping-tool\test-systems\Jabref\sources\3.7\src\main\java\net\sf\jabref\logic\layout\format\AuthorFirstLastOxfordCommas.java", "Java", 9, 0, 12, 5, 26
"c:\Users\zipasink\OneDrive\PhD\research\research-workspace\interactive-auto-mapping-tool\test-systems\Jabref\sources\3.7\src\main\java\net\sf\jabref\logic\layout\format\AuthorLF_FF.java", "Java", 10, 0, 3, 5, 18
"c:\Users\zipasink\OneDrive\PhD\research\research-workspace\interactive-auto-mapping-tool\test-systems\Jabref\sources\3.7\src\main\java\net\sf\jabref\logic\layout\format\AuthorLF_FFAbbr.java", "Java", 10, 0, 3, 5, 18
"c:\Users\zipasink\OneDrive\PhD\research\research-workspace\interactive-auto-mapping-tool\test-systems\Jabref\sources\3.7\src\main\java\net\sf\jabref\logic\layout\format\AuthorLastFirst.java", "Java", 9, 0, 0, 4, 13
"c:\Users\zipasink\OneDrive\PhD\research\research-workspace\interactive-auto-mapping-tool\test-systems\Jabref\sources\3.7\src\main\java\net\sf\jabref\logic\layout\format\AuthorLastFirstAbbrCommas.java", "Java", 9, 0, 12, 5, 26
"c:\Users\zipasink\OneDrive\PhD\research\research-workspace\interactive-auto-mapping-tool\test-systems\Jabref\sources\3.7\src\main\java\net\sf\jabref\logic\layout\format\AuthorLastFirstAbbrOxfordCommas.java", "Java", 9, 0, 13, 5, 27
"c:\Users\zipasink\OneDrive\PhD\research\research-workspace\interactive-auto-mapping-tool\test-systems\Jabref\sources\3.7\src\main\java\net\sf\jabref\logic\layout\format\AuthorLastFirstAbbreviator.java", "Java", 8, 0, 21, 6, 35
"c:\Users\zipasink\OneDrive\PhD\research\research-workspace\interactive-auto-mapping-tool\test-systems\Jabref\sources\3.7\src\main\java\net\sf\jabref\logic\layout\format\AuthorLastFirstCommas.java", "Java", 9, 0, 12, 4, 25
"c:\Users\zipasink\OneDrive\PhD\research\research-workspace\interactive-auto-mapping-tool\test-systems\Jabref\sources\3.7\src\main\java\net\sf\jabref\logic\layout\format\AuthorLastFirstOxfordCommas.java", "Java", 9, 0, 12, 4, 25
"c:\Users\zipasink\OneDrive\PhD\research\research-workspace\interactive-auto-mapping-tool\test-systems\Jabref\sources\3.7\src\main\java\net\sf\jabref\logic\layout\format\AuthorNatBib.java", "Java", 9, 0, 6, 4, 19
"c:\Users\zipasink\OneDrive\PhD\research\research-workspace\interactive-auto-mapping-tool\test-systems\Jabref\sources\3.7\src\main\java\net\sf\jabref\logic\layout\format\AuthorOrgSci.java", "Java", 20, 0, 17, 4, 41
"c:\Users\zipasink\OneDrive\PhD\research\research-workspace\interactive-auto-mapping-tool\test-systems\Jabref\sources\3.7\src\main\java\net\sf\jabref\logic\layout\format\Authors.java", "Java", 249, 0, 25, 36, 310
"c:\Users\zipasink\OneDrive\PhD\research\research-workspace\interactive-auto-mapping-tool\test-systems\Jabref\sources\3.7\src\main\java\net\sf\jabref\logic\layout\format\CompositeFormat.java", "Java", 25, 0, 8, 11, 44
"c:\Users\zipasink\OneDrive\PhD\research\research-workspace\interactive-auto-mapping-tool\test-systems\Jabref\sources\3.7\src\main\java\net\sf\jabref\logic\layout\format\CreateBibORDFAuthors.java", "Java", 29, 0, 18, 10, 57
"c:\Users\zipasink\OneDrive\PhD\research\research-workspace\interactive-auto-mapping-tool\test-systems\Jabref\sources\3.7\src\main\java\net\sf\jabref\logic\layout\format\CreateDocBookAuthors.java", "Java", 36, 0, 3, 13, 52
"c:\Users\zipasink\OneDrive\PhD\research\research-workspace\interactive-auto-mapping-tool\test-systems\Jabref\sources\3.7\src\main\java\net\sf\jabref\logic\layout\format\CreateDocBookEditors.java", "Java", 12, 0, 4, 6, 22
"c:\Users\zipasink\OneDrive\PhD\research\research-workspace\interactive-auto-mapping-tool\test-systems\Jabref\sources\3.7\src\main\java\net\sf\jabref\logic\layout\format\CurrentDate.java", "Java", 15, 0, 14, 7, 36
"c:\Users\zipasink\OneDrive\PhD\research\research-workspace\interactive-auto-mapping-tool\test-systems\Jabref\sources\3.7\src\main\java\net\sf\jabref\logic\layout\format\DOICheck.java", "Java", 16, 0, 5, 3, 24
"c:\Users\zipasink\OneDrive\PhD\research\research-workspace\interactive-auto-mapping-tool\test-systems\Jabref\sources\3.7\src\main\java\net\sf\jabref\logic\layout\format\DOIStrip.java", "Java", 12, 0, 3, 4, 19
"c:\Users\zipasink\OneDrive\PhD\research\research-workspace\interactive-auto-mapping-tool\test-systems\Jabref\sources\3.7\src\main\java\net\sf\jabref\logic\layout\format\DateFormatter.java", "Java", 17, 0, 0, 10, 27
"c:\Users\zipasink\OneDrive\PhD\research\research-workspace\interactive-auto-mapping-tool\test-systems\Jabref\sources\3.7\src\main\java\net\sf\jabref\logic\layout\format\Default.java", "Java", 13, 0, 4, 7, 24
"c:\Users\zipasink\OneDrive\PhD\research\research-workspace\interactive-auto-mapping-tool\test-systems\Jabref\sources\3.7\src\main\java\net\sf\jabref\logic\layout\format\EntryTypeFormatter.java", "Java", 14, 0, 9, 4, 27
"c:\Users\zipasink\OneDrive\PhD\research\research-workspace\interactive-auto-mapping-tool\test-systems\Jabref\sources\3.7\src\main\java\net\sf\jabref\logic\layout\format\FileLink.java", "Java", 64, 0, 20, 18, 102
"c:\Users\zipasink\OneDrive\PhD\research\research-workspace\interactive-auto-mapping-tool\test-systems\Jabref\sources\3.7\src\main\java\net\sf\jabref\logic\layout\format\FileLinkPreferences.java", "Java", 16, 0, 0, 6, 22
"c:\Users\zipasink\OneDrive\PhD\research\research-workspace\interactive-auto-mapping-tool\test-systems\Jabref\sources\3.7\src\main\java\net\sf\jabref\logic\layout\format\FirstPage.java", "Java", 16, 0, 6, 5, 27
"c:\Users\zipasink\OneDrive\PhD\research\research-workspace\interactive-auto-mapping-tool\test-systems\Jabref\sources\3.7\src\main\java\net\sf\jabref\logic\layout\format\FormatPagesForHTML.java", "Java", 8, 0, 0, 4, 12
"c:\Users\zipasink\OneDrive\PhD\research\research-workspace\interactive-auto-mapping-tool\test-systems\Jabref\sources\3.7\src\main\java\net\sf\jabref\logic\layout\format\FormatPagesForXML.java", "Java", 8, 0, 0, 4, 12
"c:\Users\zipasink\OneDrive\PhD\research\research-workspace\interactive-auto-mapping-tool\test-systems\Jabref\sources\3.7\src\main\java\net\sf\jabref\logic\layout\format\GetOpenOfficeType.java", "Java", 50, 0, 8, 4, 62
"c:\Users\zipasink\OneDrive\PhD\research\research-workspace\interactive-auto-mapping-tool\test-systems\Jabref\sources\3.7\src\main\java\net\sf\jabref\logic\layout\format\HTMLChars.java", "Java", 165, 0, 41, 20, 226
"c:\Users\zipasink\OneDrive\PhD\research\research-workspace\interactive-auto-mapping-tool\test-systems\Jabref\sources\3.7\src\main\java\net\sf\jabref\logic\layout\format\HTMLParagraphs.java", "Java", 31, 0, 4, 12, 47
"c:\Users\zipasink\OneDrive\PhD\research\research-workspace\interactive-auto-mapping-tool\test-systems\Jabref\sources\3.7\src\main\java\net\sf\jabref\logic\layout\format\IfPlural.java", "Java", 27, 0, 14, 11, 52
"c:\Users\zipasink\OneDrive\PhD\research\research-workspace\interactive-auto-mapping-tool\test-systems\Jabref\sources\3.7\src\main\java\net\sf\jabref\logic\layout\format\Iso690FormatDate.java", "Java", 20, 0, 8, 4, 32
"c:\Users\zipasink\OneDrive\PhD\research\research-workspace\interactive-auto-mapping-tool\test-systems\Jabref\sources\3.7\src\main\java\net\sf\jabref\logic\layout\format\Iso690NamesAuthors.java", "Java", 53, 0, 21, 16, 90
"c:\Users\zipasink\OneDrive\PhD\research\research-workspace\interactive-auto-mapping-tool\test-systems\Jabref\sources\3.7\src\main\java\net\sf\jabref\logic\layout\format\JournalAbbreviator.java", "Java", 19, 0, 15, 8, 42
"c:\Users\zipasink\OneDrive\PhD\research\research-workspace\interactive-auto-mapping-tool\test-systems\Jabref\sources\3.7\src\main\java\net\sf\jabref\logic\layout\format\LastPage.java", "Java", 18, 0, 6, 5, 29
"c:\Users\zipasink\OneDrive\PhD\research\research-workspace\interactive-auto-mapping-tool\test-systems\Jabref\sources\3.7\src\main\java\net\sf\jabref\logic\layout\format\LatexToUnicodeFormatter.java", "Java", 28, 0, 4, 11, 43
"c:\Users\zipasink\OneDrive\PhD\research\research-workspace\interactive-auto-mapping-tool\test-systems\Jabref\sources\3.7\src\main\java\net\sf\jabref\logic\layout\format\NameFormatter.java", "Java", 93, 0, 64, 28, 185
"c:\Users\zipasink\OneDrive\PhD\research\research-workspace\interactive-auto-mapping-tool\test-systems\Jabref\sources\3.7\src\main\java\net\sf\jabref\logic\layout\format\NameFormatterPreferences.java", "Java", 16, 0, 0, 9, 25
"c:\Users\zipasink\OneDrive\PhD\research\research-workspace\interactive-auto-mapping-tool\test-systems\Jabref\sources\3.7\src\main\java\net\sf\jabref\logic\layout\format\NoSpaceBetweenAbbreviations.java", "Java", 8, 0, 23, 4, 35
"c:\Users\zipasink\OneDrive\PhD\research\research-workspace\interactive-auto-mapping-tool\test-systems\Jabref\sources\3.7\src\main\java\net\sf\jabref\logic\layout\format\NotFoundFormatter.java", "Java", 16, 0, 4, 9, 29
"c:\Users\zipasink\OneDrive\PhD\research\research-workspace\interactive-auto-mapping-tool\test-systems\Jabref\sources\3.7\src\main\java\net\sf\jabref\logic\layout\format\Number.java", "Java", 12, 0, 5, 5, 22
"c:\Users\zipasink\OneDrive\PhD\research\research-workspace\interactive-auto-mapping-tool\test-systems\Jabref\sources\3.7\src\main\java\net\sf\jabref\logic\layout\format\Ordinal.java", "Java", 37, 0, 4, 6, 47
"c:\Users\zipasink\OneDrive\PhD\research\research-workspace\interactive-auto-mapping-tool\test-systems\Jabref\sources\3.7\src\main\java\net\sf\jabref\logic\layout\format\RTFChars.java", "Java", 281, 0, 42, 24, 347
"c:\Users\zipasink\OneDrive\PhD\research\research-workspace\interactive-auto-mapping-tool\test-systems\Jabref\sources\3.7\src\main\java\net\sf\jabref\logic\layout\format\RemoveBrackets.java", "Java", 14, 0, 7, 4, 25
"c:\Users\zipasink\OneDrive\PhD\research\research-workspace\interactive-auto-mapping-tool\test-systems\Jabref\sources\3.7\src\main\java\net\sf\jabref\logic\layout\format\RemoveBracketsAddComma.java", "Java", 16, 0, 3, 4, 23
"c:\Users\zipasink\OneDrive\PhD\research\research-workspace\interactive-auto-mapping-tool\test-systems\Jabref\sources\3.7\src\main\java\net\sf\jabref\logic\layout\format\RemoveLatexCommandsFormatter.java", "Java", 56, 0, 3, 7, 66
"c:\Users\zipasink\OneDrive\PhD\research\research-workspace\interactive-auto-mapping-tool\test-systems\Jabref\sources\3.7\src\main\java\net\sf\jabref\logic\layout\format\RemoveTilde.java", "Java", 21, 0, 6, 5, 32
"c:\Users\zipasink\OneDrive\PhD\research\research-workspace\interactive-auto-mapping-tool\test-systems\Jabref\sources\3.7\src\main\java\net\sf\jabref\logic\layout\format\RemoveWhitespace.java", "Java", 17, 0, 5, 8, 30
"c:\Users\zipasink\OneDrive\PhD\research\research-workspace\interactive-auto-mapping-tool\test-systems\Jabref\sources\3.7\src\main\java\net\sf\jabref\logic\layout\format\Replace.java", "Java", 23, 0, 29, 10, 62
"c:\Users\zipasink\OneDrive\PhD\research\research-workspace\interactive-auto-mapping-tool\test-systems\Jabref\sources\3.7\src\main\java\net\sf\jabref\logic\layout\format\RisAuthors.java", "Java", 28, 0, 0, 7, 35
"c:\Users\zipasink\OneDrive\PhD\research\research-workspace\interactive-auto-mapping-tool\test-systems\Jabref\sources\3.7\src\main\java\net\sf\jabref\logic\layout\format\RisKeywords.java", "Java", 25, 0, 0, 4, 29
"c:\Users\zipasink\OneDrive\PhD\research\research-workspace\interactive-auto-mapping-tool\test-systems\Jabref\sources\3.7\src\main\java\net\sf\jabref\logic\layout\format\RisMonth.java", "Java", 17, 0, 0, 6, 23
"c:\Users\zipasink\OneDrive\PhD\research\research-workspace\interactive-auto-mapping-tool\test-systems\Jabref\sources\3.7\src\main\java\net\sf\jabref\logic\layout\format\ToLowerCase.java", "Java", 11, 0, 3, 4, 18
"c:\Users\zipasink\OneDrive\PhD\research\research-workspace\interactive-auto-mapping-tool\test-systems\Jabref\sources\3.7\src\main\java\net\sf\jabref\logic\layout\format\ToUpperCase.java", "Java", 11, 0, 3, 6, 20
"c:\Users\zipasink\OneDrive\PhD\research\research-workspace\interactive-auto-mapping-tool\test-systems\Jabref\sources\3.7\src\main\java\net\sf\jabref\logic\layout\format\WrapContent.java", "Java", 30, 0, 9, 8, 47
"c:\Users\zipasink\OneDrive\PhD\research\research-workspace\interactive-auto-mapping-tool\test-systems\Jabref\sources\3.7\src\main\java\net\sf\jabref\logic\layout\format\WrapFileLinks.java", "Java", 170, 0, 105, 41, 316
"c:\Users\zipasink\OneDrive\PhD\research\research-workspace\interactive-auto-mapping-tool\test-systems\Jabref\sources\3.7\src\main\java\net\sf\jabref\logic\layout\format\XMLChars.java", "Java", 65, 0, 11, 26, 102
"c:\Users\zipasink\OneDrive\PhD\research\research-workspace\interactive-auto-mapping-tool\test-systems\Jabref\sources\3.7\src\main\java\net\sf\jabref\logic\logging\Cache.java", "Java", 42, 0, 8, 13, 63
"c:\Users\zipasink\OneDrive\PhD\research\research-workspace\interactive-auto-mapping-tool\test-systems\Jabref\sources\3.7\src\main\java\net\sf\jabref\logic\logging\GuiAppender.java", "Java", 35, 0, 0, 12, 47
"c:\Users\zipasink\OneDrive\PhD\research\research-workspace\interactive-auto-mapping-tool\test-systems\Jabref\sources\3.7\src\main\java\net\sf\jabref\logic\logging\JabRefLogger.java", "Java", 22, 0, 0, 6, 28
"c:\Users\zipasink\OneDrive\PhD\research\research-workspace\interactive-auto-mapping-tool\test-systems\Jabref\sources\3.7\src\main\java\net\sf\jabref\logic\msbib\BibTeXConverter.java", "Java", 101, 0, 11, 24, 136
"c:\Users\zipasink\OneDrive\PhD\research\research-workspace\interactive-auto-mapping-tool\test-systems\Jabref\sources\3.7\src\main\java\net\sf\jabref\logic\msbib\MSBibConverter.java", "Java", 88, 0, 10, 29, 127
"c:\Users\zipasink\OneDrive\PhD\research\research-workspace\interactive-auto-mapping-tool\test-systems\Jabref\sources\3.7\src\main\java\net\sf\jabref\logic\msbib\MSBibDatabase.java", "Java", 94, 0, 23, 19, 136
"c:\Users\zipasink\OneDrive\PhD\research\research-workspace\interactive-auto-mapping-tool\test-systems\Jabref\sources\3.7\src\main\java\net\sf\jabref\logic\msbib\MSBibEntry.java", "Java", 271, 0, 31, 50, 352
"c:\Users\zipasink\OneDrive\PhD\research\research-workspace\interactive-auto-mapping-tool\test-systems\Jabref\sources\3.7\src\main\java\net\sf\jabref\logic\msbib\MSBibEntryType.java", "Java", 20, 0, 9, 2, 31
"c:\Users\zipasink\OneDrive\PhD\research\research-workspace\interactive-auto-mapping-tool\test-systems\Jabref\sources\3.7\src\main\java\net\sf\jabref\logic\msbib\MSBibMapping.java", "Java", 108, 0, 24, 24, 156
"c:\Users\zipasink\OneDrive\PhD\research\research-workspace\interactive-auto-mapping-tool\test-systems\Jabref\sources\3.7\src\main\java\net\sf\jabref\logic\msbib\PageNumbers.java", "Java", 50, 0, 0, 11, 61
"c:\Users\zipasink\OneDrive\PhD\research\research-workspace\interactive-auto-mapping-tool\test-systems\Jabref\sources\3.7\src\main\java\net\sf\jabref\logic\msbib\PersonName.java", "Java", 88, 0, 16, 25, 129
"c:\Users\zipasink\OneDrive\PhD\research\research-workspace\interactive-auto-mapping-tool\test-systems\Jabref\sources\3.7\src\main\java\net\sf\jabref\logic\net\ProxyAuthenticator.java", "Java", 19, 0, 0, 4, 23
"c:\Users\zipasink\OneDrive\PhD\research\research-workspace\interactive-auto-mapping-tool\test-systems\Jabref\sources\3.7\src\main\java\net\sf\jabref\logic\net\ProxyPreferences.java", "Java", 94, 0, 0, 13, 107
"c:\Users\zipasink\OneDrive\PhD\research\research-workspace\interactive-auto-mapping-tool\test-systems\Jabref\sources\3.7\src\main\java\net\sf\jabref\logic\net\ProxyRegisterer.java", "Java", 16, 0, 4, 4, 24
"c:\Users\zipasink\OneDrive\PhD\research\research-workspace\interactive-auto-mapping-tool\test-systems\Jabref\sources\3.7\src\main\java\net\sf\jabref\logic\net\URLDownload.java", "Java", 157, 0, 43, 38, 238
"c:\Users\zipasink\OneDrive\PhD\research\research-workspace\interactive-auto-mapping-tool\test-systems\Jabref\sources\3.7\src\main\java\net\sf\jabref\logic\net\URLUtil.java", "Java", 40, 0, 25, 10, 75
"c:\Users\zipasink\OneDrive\PhD\research\research-workspace\interactive-auto-mapping-tool\test-systems\Jabref\sources\3.7\src\main\java\net\sf\jabref\logic\openoffice\CitationEntry.java", "Java", 61, 0, 4, 16, 81
"c:\Users\zipasink\OneDrive\PhD\research\research-workspace\interactive-auto-mapping-tool\test-systems\Jabref\sources\3.7\src\main\java\net\sf\jabref\logic\openoffice\OOBibStyle.java", "Java", 618, 0, 205, 97, 920
"c:\Users\zipasink\OneDrive\PhD\research\research-workspace\interactive-auto-mapping-tool\test-systems\Jabref\sources\3.7\src\main\java\net\sf\jabref\logic\openoffice\OOPreFormatter.java", "Java", 161, 0, 46, 23, 230
"c:\Users\zipasink\OneDrive\PhD\research\research-workspace\interactive-auto-mapping-tool\test-systems\Jabref\sources\3.7\src\main\java\net\sf\jabref\logic\openoffice\OOUtil.java", "Java", 203, 0, 47, 38, 288
"c:\Users\zipasink\OneDrive\PhD\research\research-workspace\interactive-auto-mapping-tool\test-systems\Jabref\sources\3.7\src\main\java\net\sf\jabref\logic\openoffice\OpenOfficeFileSearch.java", "Java", 86, 0, 20, 16, 122
"c:\Users\zipasink\OneDrive\PhD\research\research-workspace\interactive-auto-mapping-tool\test-systems\Jabref\sources\3.7\src\main\java\net\sf\jabref\logic\openoffice\OpenOfficePreferences.java", "Java", 90, 0, 12, 26, 128
"c:\Users\zipasink\OneDrive\PhD\research\research-workspace\interactive-auto-mapping-tool\test-systems\Jabref\sources\3.7\src\main\java\net\sf\jabref\logic\openoffice\StyleLoader.java", "Java", 113, 0, 12, 20, 145
"c:\Users\zipasink\OneDrive\PhD\research\research-workspace\interactive-auto-mapping-tool\test-systems\Jabref\sources\3.7\src\main\java\net\sf\jabref\logic\openoffice\UndefinedBibtexEntry.java", "Java", 15, 0, 4, 7, 26
"c:\Users\zipasink\OneDrive\PhD\research\research-workspace\interactive-auto-mapping-tool\test-systems\Jabref\sources\3.7\src\main\java\net\sf\jabref\logic\openoffice\UndefinedParagraphFormatException.java", "Java", 11, 0, 4, 6, 21
"c:\Users\zipasink\OneDrive\PhD\research\research-workspace\interactive-auto-mapping-tool\test-systems\Jabref\sources\3.7\src\main\java\net\sf\jabref\logic\protectedterms\ProtectedTermsList.java", "Java", 91, 0, 1, 26, 118
"c:\Users\zipasink\OneDrive\PhD\research\research-workspace\interactive-auto-mapping-tool\test-systems\Jabref\sources\3.7\src\main\java\net\sf\jabref\logic\protectedterms\ProtectedTermsLoader.java", "Java", 141, 0, 7, 28, 176
"c:\Users\zipasink\OneDrive\PhD\research\research-workspace\interactive-auto-mapping-tool\test-systems\Jabref\sources\3.7\src\main\java\net\sf\jabref\logic\protectedterms\ProtectedTermsParser.java", "Java", 78, 0, 9, 18, 105
"c:\Users\zipasink\OneDrive\PhD\research\research-workspace\interactive-auto-mapping-tool\test-systems\Jabref\sources\3.7\src\main\java\net\sf\jabref\logic\protectedterms\ProtectedTermsPreferences.java", "Java", 27, 0, 0, 11, 38
"c:\Users\zipasink\OneDrive\PhD\research\research-workspace\interactive-auto-mapping-tool\test-systems\Jabref\sources\3.7\src\main\java\net\sf\jabref\logic\remote\RemotePreferences.java", "Java", 24, 0, 3, 11, 38
"c:\Users\zipasink\OneDrive\PhD\research\research-workspace\interactive-auto-mapping-tool\test-systems\Jabref\sources\3.7\src\main\java\net\sf\jabref\logic\remote\RemoteUtil.java", "Java", 6, 0, 0, 3, 9
"c:\Users\zipasink\OneDrive\PhD\research\research-workspace\interactive-auto-mapping-tool\test-systems\Jabref\sources\3.7\src\main\java\net\sf\jabref\logic\remote\client\RemoteListenerClient.java", "Java", 34, 0, 6, 11, 51
"c:\Users\zipasink\OneDrive\PhD\research\research-workspace\interactive-auto-mapping-tool\test-systems\Jabref\sources\3.7\src\main\java\net\sf\jabref\logic\remote\server\MessageHandler.java", "Java", 5, 0, 0, 4, 9
"c:\Users\zipasink\OneDrive\PhD\research\research-workspace\interactive-auto-mapping-tool\test-systems\Jabref\sources\3.7\src\main\java\net\sf\jabref\logic\remote\server\RemoteListenerServer.java", "Java", 50, 0, 1, 15, 66
"c:\Users\zipasink\OneDrive\PhD\research\research-workspace\interactive-auto-mapping-tool\test-systems\Jabref\sources\3.7\src\main\java\net\sf\jabref\logic\remote\server\RemoteListenerServerLifecycle.java", "Java", 50, 0, 13, 15, 78
"c:\Users\zipasink\OneDrive\PhD\research\research-workspace\interactive-auto-mapping-tool\test-systems\Jabref\sources\3.7\src\main\java\net\sf\jabref\logic\remote\server\RemoteListenerServerThread.java", "Java", 22, 0, 3, 11, 36
"c:\Users\zipasink\OneDrive\PhD\research\research-workspace\interactive-auto-mapping-tool\test-systems\Jabref\sources\3.7\src\main\java\net\sf\jabref\logic\remote\shared\Protocol.java", "Java", 51, 0, 6, 14, 71
"c:\Users\zipasink\OneDrive\PhD\research\research-workspace\interactive-auto-mapping-tool\test-systems\Jabref\sources\3.7\src\main\java\net\sf\jabref\logic\search\DatabaseSearcher.java", "Java", 28, 0, 3, 12, 43
"c:\Users\zipasink\OneDrive\PhD\research\research-workspace\interactive-auto-mapping-tool\test-systems\Jabref\sources\3.7\src\main\java\net\sf\jabref\logic\search\SearchQuery.java", "Java", 97, 0, 6, 21, 124
"c:\Users\zipasink\OneDrive\PhD\research\research-workspace\interactive-auto-mapping-tool\test-systems\Jabref\sources\3.7\src\main\java\net\sf\jabref\logic\search\SearchQueryHighlightListener.java", "Java", 9, 0, 12, 5, 26
"c:\Users\zipasink\OneDrive\PhD\research\research-workspace\interactive-auto-mapping-tool\test-systems\Jabref\sources\3.7\src\main\java\net\sf\jabref\logic\search\SearchQueryHighlightObservable.java", "Java", 48, 0, 15, 19, 82
"c:\Users\zipasink\OneDrive\PhD\research\research-workspace\interactive-auto-mapping-tool\test-systems\Jabref\sources\3.7\src\main\java\net\sf\jabref\logic\search\rules\describer\ContainsAndRegexBasedSearchRuleDescriber.java", "Java", 45, 0, 0, 11, 56
"c:\Users\zipasink\OneDrive\PhD\research\research-workspace\interactive-auto-mapping-tool\test-systems\Jabref\sources\3.7\src\main\java\net\sf\jabref\logic\search\rules\describer\GrammarBasedSearchRuleDescriber.java", "Java", 92, 0, 1, 19, 112
"c:\Users\zipasink\OneDrive\PhD\research\research-workspace\interactive-auto-mapping-tool\test-systems\Jabref\sources\3.7\src\main\java\net\sf\jabref\logic\search\rules\describer\SearchDescriber.java", "Java", 5, 0, 0, 4, 9
"c:\Users\zipasink\OneDrive\PhD\research\research-workspace\interactive-auto-mapping-tool\test-systems\Jabref\sources\3.7\src\main\java\net\sf\jabref\logic\search\rules\describer\SearchDescribers.java", "Java", 21, 0, 7, 8, 36
"c:\Users\zipasink\OneDrive\PhD\research\research-workspace\interactive-auto-mapping-tool\test-systems\Jabref\sources\3.7\src\main\java\net\sf\jabref\logic\specialfields\SpecialFieldsUtils.java", "Java", 76, 0, 24, 26, 126
"c:\Users\zipasink\OneDrive\PhD\research\research-workspace\interactive-auto-mapping-tool\test-systems\Jabref\sources\3.7\src\main\java\net\sf\jabref\logic\undo\AddUndoableActionEvent.java", "Java", 6, 0, 4, 4, 14
"c:\Users\zipasink\OneDrive\PhD\research\research-workspace\interactive-auto-mapping-tool\test-systems\Jabref\sources\3.7\src\main\java\net\sf\jabref\logic\undo\UndoChangeEvent.java", "Java", 25, 0, 20, 11, 56
"c:\Users\zipasink\OneDrive\PhD\research\research-workspace\interactive-auto-mapping-tool\test-systems\Jabref\sources\3.7\src\main\java\net\sf\jabref\logic\undo\UndoRedoEvent.java", "Java", 6, 0, 4, 4, 14
"c:\Users\zipasink\OneDrive\PhD\research\research-workspace\interactive-auto-mapping-tool\test-systems\Jabref\sources\3.7\src\main\java\net\sf\jabref\logic\util\BuildInfo.java", "Java", 47, 0, 1, 17, 65
"c:\Users\zipasink\OneDrive\PhD\research\research-workspace\interactive-auto-mapping-tool\test-systems\Jabref\sources\3.7\src\main\java\net\sf\jabref\logic\util\DOI.java", "Java", 88, 0, 61, 21, 170
"c:\Users\zipasink\OneDrive\PhD\research\research-workspace\interactive-auto-mapping-tool\test-systems\Jabref\sources\3.7\src\main\java\net\sf\jabref\logic\util\FileExtensions.java", "Java", 53, 0, 7, 10, 70
"c:\Users\zipasink\OneDrive\PhD\research\research-workspace\interactive-auto-mapping-tool\test-systems\Jabref\sources\3.7\src\main\java\net\sf\jabref\logic\util\ISBN.java", "Java", 61, 0, 3, 16, 80
"c:\Users\zipasink\OneDrive\PhD\research\research-workspace\interactive-auto-mapping-tool\test-systems\Jabref\sources\3.7\src\main\java\net\sf\jabref\logic\util\ISSN.java", "Java", 41, 0, 1, 11, 53
"c:\Users\zipasink\OneDrive\PhD\research\research-workspace\interactive-auto-mapping-tool\test-systems\Jabref\sources\3.7\src\main\java\net\sf\jabref\logic\util\OS.java", "Java", 9, 0, 7, 5, 21
"c:\Users\zipasink\OneDrive\PhD\research\research-workspace\interactive-auto-mapping-tool\test-systems\Jabref\sources\3.7\src\main\java\net\sf\jabref\logic\util\OptionalUtil.java", "Java", 19, 0, 0, 5, 24
"c:\Users\zipasink\OneDrive\PhD\research\research-workspace\interactive-auto-mapping-tool\test-systems\Jabref\sources\3.7\src\main\java\net\sf\jabref\logic\util\TestEntry.java", "Java", 26, 0, 0, 5, 31
"c:\Users\zipasink\OneDrive\PhD\research\research-workspace\interactive-auto-mapping-tool\test-systems\Jabref\sources\3.7\src\main\java\net\sf\jabref\logic\util\UpdateField.java", "Java", 82, 0, 47, 19, 148
"c:\Users\zipasink\OneDrive\PhD\research\research-workspace\interactive-auto-mapping-tool\test-systems\Jabref\sources\3.7\src\main\java\net\sf\jabref\logic\util\UpdateFieldPreferences.java", "Java", 42, 0, 0, 15, 57
"c:\Users\zipasink\OneDrive\PhD\research\research-workspace\interactive-auto-mapping-tool\test-systems\Jabref\sources\3.7\src\main\java\net\sf\jabref\logic\util\Version.java", "Java", 201, 0, 44, 44, 289
"c:\Users\zipasink\OneDrive\PhD\research\research-workspace\interactive-auto-mapping-tool\test-systems\Jabref\sources\3.7\src\main\java\net\sf\jabref\logic\util\date\EasyDateFormat.java", "Java", 29, 0, 23, 12, 64
"c:\Users\zipasink\OneDrive\PhD\research\research-workspace\interactive-auto-mapping-tool\test-systems\Jabref\sources\3.7\src\main\java\net\sf\jabref\logic\util\io\DatabaseFileLookup.java", "Java", 43, 0, 28, 15, 86
"c:\Users\zipasink\OneDrive\PhD\research\research-workspace\interactive-auto-mapping-tool\test-systems\Jabref\sources\3.7\src\main\java\net\sf\jabref\logic\util\io\FileBasedLock.java", "Java", 73, 0, 36, 15, 124
"c:\Users\zipasink\OneDrive\PhD\research\research-workspace\interactive-auto-mapping-tool\test-systems\Jabref\sources\3.7\src\main\java\net\sf\jabref\logic\util\io\FileFinder.java", "Java", 35, 0, 0, 13, 48
"c:\Users\zipasink\OneDrive\PhD\research\research-workspace\interactive-auto-mapping-tool\test-systems\Jabref\sources\3.7\src\main\java\net\sf\jabref\logic\util\io\FileHistory.java", "Java", 33, 0, 5, 14, 52
"c:\Users\zipasink\OneDrive\PhD\research\research-workspace\interactive-auto-mapping-tool\test-systems\Jabref\sources\3.7\src\main\java\net\sf\jabref\logic\util\io\FileNameCleaner.java", "Java", 30, 0, 16, 7, 53
"c:\Users\zipasink\OneDrive\PhD\research\research-workspace\interactive-auto-mapping-tool\test-systems\Jabref\sources\3.7\src\main\java\net\sf\jabref\logic\util\io\FileUtil.java", "Java", 270, 0, 112, 51, 433
"c:\Users\zipasink\OneDrive\PhD\research\research-workspace\interactive-auto-mapping-tool\test-systems\Jabref\sources\3.7\src\main\java\net\sf\jabref\logic\util\io\RegExpFileSearch.java", "Java", 189, 0, 105, 50, 344
"c:\Users\zipasink\OneDrive\PhD\research\research-workspace\interactive-auto-mapping-tool\test-systems\Jabref\sources\3.7\src\main\java\net\sf\jabref\logic\util\io\XMLUtil.java", "Java", 79, 0, 36, 17, 132
"c:\Users\zipasink\OneDrive\PhD\research\research-workspace\interactive-auto-mapping-tool\test-systems\Jabref\sources\3.7\src\main\java\net\sf\jabref\logic\util\strings\DiffHighlighting.java", "Java", 92, 0, 0, 10, 102
"c:\Users\zipasink\OneDrive\PhD\research\research-workspace\interactive-auto-mapping-tool\test-systems\Jabref\sources\3.7\src\main\java\net\sf\jabref\logic\util\strings\QuotedStringTokenizer.java", "Java", 45, 0, 17, 8, 70
"c:\Users\zipasink\OneDrive\PhD\research\research-workspace\interactive-auto-mapping-tool\test-systems\Jabref\sources\3.7\src\main\java\net\sf\jabref\logic\util\strings\RtfCharMap.java", "Java", 200, 0, 23, 47, 270
"c:\Users\zipasink\OneDrive\PhD\research\research-workspace\interactive-auto-mapping-tool\test-systems\Jabref\sources\3.7\src\main\java\net\sf\jabref\logic\util\strings\StringLengthComparator.java", "Java", 13, 0, 0, 4, 17
"c:\Users\zipasink\OneDrive\PhD\research\research-workspace\interactive-auto-mapping-tool\test-systems\Jabref\sources\3.7\src\main\java\net\sf\jabref\logic\util\strings\XmlCharsMap.java", "Java", 113, 0, 7, 16, 136
"c:\Users\zipasink\OneDrive\PhD\research\research-workspace\interactive-auto-mapping-tool\test-systems\Jabref\sources\3.7\src\main\java\net\sf\jabref\logic\xmp\EncryptedPdfsNotSupportedException.java", "Java", 4, 0, 1, 3, 8
"c:\Users\zipasink\OneDrive\PhD\research\research-workspace\interactive-auto-mapping-tool\test-systems\Jabref\sources\3.7\src\main\java\net\sf\jabref\logic\xmp\XMPPreferences.java", "Java", 21, 0, 0, 9, 30
"c:\Users\zipasink\OneDrive\PhD\research\research-workspace\interactive-auto-mapping-tool\test-systems\Jabref\sources\3.7\src\main\java\net\sf\jabref\logic\xmp\XMPSchemaBibtex.java", "Java", 208, 0, 63, 58, 329
"c:\Users\zipasink\OneDrive\PhD\research\research-workspace\interactive-auto-mapping-tool\test-systems\Jabref\sources\3.7\src\main\java\net\sf\jabref\logic\xmp\XMPUtil.java", "Java", 519, 0, 485, 117, 1121
"c:\Users\zipasink\OneDrive\PhD\research\research-workspace\interactive-auto-mapping-tool\test-systems\Jabref\sources\3.7\src\main\java\net\sf\jabref\migrations\FileLinksUpgradeWarning.java", "Java", 166, 0, 54, 34, 254
"c:\Users\zipasink\OneDrive\PhD\research\research-workspace\interactive-auto-mapping-tool\test-systems\Jabref\sources\3.7\src\main\java\net\sf\jabref\migrations\PreferencesMigrations.java", "Java", 105, 0, 18, 20, 143
"c:\Users\zipasink\OneDrive\PhD\research\research-workspace\interactive-auto-mapping-tool\test-systems\Jabref\sources\3.7\src\main\java\net\sf\jabref\model\ChainNode.java", "Java", 55, 0, 81, 19, 155
"c:\Users\zipasink\OneDrive\PhD\research\research-workspace\interactive-auto-mapping-tool\test-systems\Jabref\sources\3.7\src\main\java\net\sf\jabref\model\Defaults.java", "Java", 11, 0, 0, 7, 18
"c:\Users\zipasink\OneDrive\PhD\research\research-workspace\interactive-auto-mapping-tool\test-systems\Jabref\sources\3.7\src\main\java\net\sf\jabref\model\DuplicateCheck.java", "Java", 206, 0, 57, 34, 297
"c:\Users\zipasink\OneDrive\PhD\research\research-workspace\interactive-auto-mapping-tool\test-systems\Jabref\sources\3.7\src\main\java\net\sf\jabref\model\EntryTypes.java", "Java", 102, 0, 43, 30, 175
"c:\Users\zipasink\OneDrive\PhD\research\research-workspace\interactive-auto-mapping-tool\test-systems\Jabref\sources\3.7\src\main\java\net\sf\jabref\model\FieldChange.java", "Java", 75, 0, 3, 14, 92
"c:\Users\zipasink\OneDrive\PhD\research\research-workspace\interactive-auto-mapping-tool\test-systems\Jabref\sources\3.7\src\main\java\net\sf\jabref\model\bibtexkeypattern\AbstractBibtexKeyPattern.java", "Java", 81, 0, 48, 21, 150
"c:\Users\zipasink\OneDrive\PhD\research\research-workspace\interactive-auto-mapping-tool\test-systems\Jabref\sources\3.7\src\main\java\net\sf\jabref\model\bibtexkeypattern\DatabaseBibtexKeyPattern.java", "Java", 12, 0, 0, 8, 20
"c:\Users\zipasink\OneDrive\PhD\research\research-workspace\interactive-auto-mapping-tool\test-systems\Jabref\sources\3.7\src\main\java\net\sf\jabref\model\bibtexkeypattern\GlobalBibtexKeyPattern.java", "Java", 12, 0, 0, 6, 18
"c:\Users\zipasink\OneDrive\PhD\research\research-workspace\interactive-auto-mapping-tool\test-systems\Jabref\sources\3.7\src\main\java\net\sf\jabref\model\cleanup\CleanupJob.java", "Java", 8, 0, 3, 6, 17
"c:\Users\zipasink\OneDrive\PhD\research\research-workspace\interactive-auto-mapping-tool\test-systems\Jabref\sources\3.7\src\main\java\net\sf\jabref\model\cleanup\FieldFormatterCleanup.java", "Java", 88, 0, 13, 20, 121
"c:\Users\zipasink\OneDrive\PhD\research\research-workspace\interactive-auto-mapping-tool\test-systems\Jabref\sources\3.7\src\main\java\net\sf\jabref\model\cleanup\FieldFormatterCleanups.java", "Java", 90, 0, 4, 29, 123
"c:\Users\zipasink\OneDrive\PhD\research\research-workspace\interactive-auto-mapping-tool\test-systems\Jabref\sources\3.7\src\main\java\net\sf\jabref\model\cleanup\Formatter.java", "Java", 18, 0, 48, 9, 75
"c:\Users\zipasink\OneDrive\PhD\research\research-workspace\interactive-auto-mapping-tool\test-systems\Jabref\sources\3.7\src\main\java\net\sf\jabref\model\database\BibDatabase.java", "Java", 293, 0, 196, 77, 566
"c:\Users\zipasink\OneDrive\PhD\research\research-workspace\interactive-auto-mapping-tool\test-systems\Jabref\sources\3.7\src\main\java\net\sf\jabref\model\database\BibDatabaseContext.java", "Java", 161, 0, 38, 41, 240
"c:\Users\zipasink\OneDrive\PhD\research\research-workspace\interactive-auto-mapping-tool\test-systems\Jabref\sources\3.7\src\main\java\net\sf\jabref\model\database\BibDatabaseMode.java", "Java", 33, 0, 28, 8, 69
"c:\Users\zipasink\OneDrive\PhD\research\research-workspace\interactive-auto-mapping-tool\test-systems\Jabref\sources\3.7\src\main\java\net\sf\jabref\model\database\BibDatabaseModeDetection.java", "Java", 29, 0, 15, 9, 53
"c:\Users\zipasink\OneDrive\PhD\research\research-workspace\interactive-auto-mapping-tool\test-systems\Jabref\sources\3.7\src\main\java\net\sf\jabref\model\database\BibDatabases.java", "Java", 19, 0, 12, 8, 39
"c:\Users\zipasink\OneDrive\PhD\research\research-workspace\interactive-auto-mapping-tool\test-systems\Jabref\sources\3.7\src\main\java\net\sf\jabref\model\database\DatabaseLocation.java", "Java", 5, 0, 3, 2, 10
"c:\Users\zipasink\OneDrive\PhD\research\research-workspace\interactive-auto-mapping-tool\test-systems\Jabref\sources\3.7\src\main\java\net\sf\jabref\model\database\DuplicationChecker.java", "Java", 59, 0, 34, 18, 111
"c:\Users\zipasink\OneDrive\PhD\research\research-workspace\interactive-auto-mapping-tool\test-systems\Jabref\sources\3.7\src\main\java\net\sf\jabref\model\database\EntrySorter.java", "Java", 19, 0, 0, 9, 28
"c:\Users\zipasink\OneDrive\PhD\research\research-workspace\interactive-auto-mapping-tool\test-systems\Jabref\sources\3.7\src\main\java\net\sf\jabref\model\database\KeyChangeListener.java", "Java", 71, 0, 1, 16, 88
"c:\Users\zipasink\OneDrive\PhD\research\research-workspace\interactive-auto-mapping-tool\test-systems\Jabref\sources\3.7\src\main\java\net\sf\jabref\model\database\KeyCollisionException.java", "Java", 15, 0, 0, 6, 21
"c:\Users\zipasink\OneDrive\PhD\research\research-workspace\interactive-auto-mapping-tool\test-systems\Jabref\sources\3.7\src\main\java\net\sf\jabref\model\database\event\AutosaveEvent.java", "Java", 3, 0, 4, 2, 9
"c:\Users\zipasink\OneDrive\PhD\research\research-workspace\interactive-auto-mapping-tool\test-systems\Jabref\sources\3.7\src\main\java\net\sf\jabref\model\database\event\BibDatabaseContextChangedEvent.java", "Java", 4, 0, 4, 3, 11
"c:\Users\zipasink\OneDrive\PhD\research\research-workspace\interactive-auto-mapping-tool\test-systems\Jabref\sources\3.7\src\main\java\net\sf\jabref\model\database\event\ChangePropagation.java", "Java", 4, 0, 0, 3, 7
"c:\Users\zipasink\OneDrive\PhD\research\research-workspace\interactive-auto-mapping-tool\test-systems\Jabref\sources\3.7\src\main\java\net\sf\jabref\model\database\event\EntryAddedEvent.java", "Java", 13, 0, 10, 5, 28
"c:\Users\zipasink\OneDrive\PhD\research\research-workspace\interactive-auto-mapping-tool\test-systems\Jabref\sources\3.7\src\main\java\net\sf\jabref\model\database\event\EntryRemovedEvent.java", "Java", 12, 0, 11, 7, 30
"c:\Users\zipasink\OneDrive\PhD\research\research-workspace\interactive-auto-mapping-tool\test-systems\Jabref\sources\3.7\src\main\java\net\sf\jabref\model\entry\Author.java", "Java", 213, 0, 128, 40, 381
"c:\Users\zipasink\OneDrive\PhD\research\research-workspace\interactive-auto-mapping-tool\test-systems\Jabref\sources\3.7\src\main\java\net\sf\jabref\model\entry\AuthorList.java", "Java", 266, 0, 331, 61, 658
"c:\Users\zipasink\OneDrive\PhD\research\research-workspace\interactive-auto-mapping-tool\test-systems\Jabref\sources\3.7\src\main\java\net\sf\jabref\model\entry\AuthorListParser.java", "Java", 283, 0, 87, 36, 406
"c:\Users\zipasink\OneDrive\PhD\research\research-workspace\interactive-auto-mapping-tool\test-systems\Jabref\sources\3.7\src\main\java\net\sf\jabref\model\entry\BibEntry.java", "Java", 487, 0, 211, 130, 828
"c:\Users\zipasink\OneDrive\PhD\research\research-workspace\interactive-auto-mapping-tool\test-systems\Jabref\sources\3.7\src\main\java\net\sf\jabref\model\entry\BibLatexEntryType.java", "Java", 51, 0, 3, 17, 71
"c:\Users\zipasink\OneDrive\PhD\research\research-workspace\interactive-auto-mapping-tool\test-systems\Jabref\sources\3.7\src\main\java\net\sf\jabref\model\entry\BibLatexEntryTypes.java", "Java", 737, 0, 22, 197, 956
"c:\Users\zipasink\OneDrive\PhD\research\research-workspace\interactive-auto-mapping-tool\test-systems\Jabref\sources\3.7\src\main\java\net\sf\jabref\model\entry\BibtexEntryType.java", "Java", 43, 0, 3, 14, 60
"c:\Users\zipasink\OneDrive\PhD\research\research-workspace\interactive-auto-mapping-tool\test-systems\Jabref\sources\3.7\src\main\java\net\sf\jabref\model\entry\BibtexEntryTypes.java", "Java", 154, 0, 88, 46, 288
"c:\Users\zipasink\OneDrive\PhD\research\research-workspace\interactive-auto-mapping-tool\test-systems\Jabref\sources\3.7\src\main\java\net\sf\jabref\model\entry\BibtexSingleField.java", "Java", 105, 0, 33, 37, 175
"c:\Users\zipasink\OneDrive\PhD\research\research-workspace\interactive-auto-mapping-tool\test-systems\Jabref\sources\3.7\src\main\java\net\sf\jabref\model\entry\BibtexString.java", "Java", 97, 0, 49, 27, 173
"c:\Users\zipasink\OneDrive\PhD\research\research-workspace\interactive-auto-mapping-tool\test-systems\Jabref\sources\3.7\src\main\java\net\sf\jabref\model\entry\CanonicalBibtexEntry.java", "Java", 34, 0, 12, 10, 56
"c:\Users\zipasink\OneDrive\PhD\research\research-workspace\interactive-auto-mapping-tool\test-systems\Jabref\sources\3.7\src\main\java\net\sf\jabref\model\entry\CustomEntryType.java", "Java", 104, 0, 8, 20, 132
"c:\Users\zipasink\OneDrive\PhD\research\research-workspace\interactive-auto-mapping-tool\test-systems\Jabref\sources\3.7\src\main\java\net\sf\jabref\model\entry\EntryConverter.java", "Java", 26, 0, 8, 6, 40
"c:\Users\zipasink\OneDrive\PhD\research\research-workspace\interactive-auto-mapping-tool\test-systems\Jabref\sources\3.7\src\main\java\net\sf\jabref\model\entry\EntryLinkList.java", "Java", 21, 0, 0, 9, 30
"c:\Users\zipasink\OneDrive\PhD\research\research-workspace\interactive-auto-mapping-tool\test-systems\Jabref\sources\3.7\src\main\java\net\sf\jabref\model\entry\EntryType.java", "Java", 25, 0, 38, 11, 74
"c:\Users\zipasink\OneDrive\PhD\research\research-workspace\interactive-auto-mapping-tool\test-systems\Jabref\sources\3.7\src\main\java\net\sf\jabref\model\entry\FieldName.java", "Java", 166, 0, 15, 16, 197
"c:\Users\zipasink\OneDrive\PhD\research\research-workspace\interactive-auto-mapping-tool\test-systems\Jabref\sources\3.7\src\main\java\net\sf\jabref\model\entry\FieldProperty.java", "Java", 31, 0, 0, 5, 36
"c:\Users\zipasink\OneDrive\PhD\research\research-workspace\interactive-auto-mapping-tool\test-systems\Jabref\sources\3.7\src\main\java\net\sf\jabref\model\entry\FileField.java", "Java", 96, 0, 17, 16, 129
"c:\Users\zipasink\OneDrive\PhD\research\research-workspace\interactive-auto-mapping-tool\test-systems\Jabref\sources\3.7\src\main\java\net\sf\jabref\model\entry\IEEETranEntryTypes.java", "Java", 64, 0, 34, 19, 117
"c:\Users\zipasink\OneDrive\PhD\research\research-workspace\interactive-auto-mapping-tool\test-systems\Jabref\sources\3.7\src\main\java\net\sf\jabref\model\entry\IdGenerator.java", "Java", 19, 0, 5, 9, 33
"c:\Users\zipasink\OneDrive\PhD\research\research-workspace\interactive-auto-mapping-tool\test-systems\Jabref\sources\3.7\src\main\java\net\sf\jabref\model\entry\InternalBibtexFields.java", "Java", 381, 0, 71, 86, 538
"c:\Users\zipasink\OneDrive\PhD\research\research-workspace\interactive-auto-mapping-tool\test-systems\Jabref\sources\3.7\src\main\java\net\sf\jabref\model\entry\Keyword.java", "Java", 32, 0, 4, 10, 46
"c:\Users\zipasink\OneDrive\PhD\research\research-workspace\interactive-auto-mapping-tool\test-systems\Jabref\sources\3.7\src\main\java\net\sf\jabref\model\entry\KeywordList.java", "Java", 132, 0, 16, 34, 182
"c:\Users\zipasink\OneDrive\PhD\research\research-workspace\interactive-auto-mapping-tool\test-systems\Jabref\sources\3.7\src\main\java\net\sf\jabref\model\entry\MonthUtil.java", "Java", 86, 0, 31, 23, 140
"c:\Users\zipasink\OneDrive\PhD\research\research-workspace\interactive-auto-mapping-tool\test-systems\Jabref\sources\3.7\src\main\java\net\sf\jabref\model\entry\ParsedEntryLink.java", "Java", 46, 0, 0, 14, 60
"c:\Users\zipasink\OneDrive\PhD\research\research-workspace\interactive-auto-mapping-tool\test-systems\Jabref\sources\3.7\src\main\java\net\sf\jabref\model\entry\ParsedFileField.java", "Java", 58, 0, 0, 16, 74
"c:\Users\zipasink\OneDrive\PhD\research\research-workspace\interactive-auto-mapping-tool\test-systems\Jabref\sources\3.7\src\main\java\net\sf\jabref\model\entry\SharedBibEntryData.java", "Java", 21, 0, 7, 10, 38
"c:\Users\zipasink\OneDrive\PhD\research\research-workspace\interactive-auto-mapping-tool\test-systems\Jabref\sources\3.7\src\main\java\net\sf\jabref\model\entry\event\EntryChangedEvent.java", "Java", 10, 0, 10, 7, 27
"c:\Users\zipasink\OneDrive\PhD\research\research-workspace\interactive-auto-mapping-tool\test-systems\Jabref\sources\3.7\src\main\java\net\sf\jabref\model\entry\event\EntryEvent.java", "Java", 21, 0, 11, 10, 42
"c:\Users\zipasink\OneDrive\PhD\research\research-workspace\interactive-auto-mapping-tool\test-systems\Jabref\sources\3.7\src\main\java\net\sf\jabref\model\entry\event\EntryEventSource.java", "Java", 7, 0, 3, 2, 12
"c:\Users\zipasink\OneDrive\PhD\research\research-workspace\interactive-auto-mapping-tool\test-systems\Jabref\sources\3.7\src\main\java\net\sf\jabref\model\entry\event\FieldChangedEvent.java", "Java", 39, 0, 21, 13, 73
"c:\Users\zipasink\OneDrive\PhD\research\research-workspace\interactive-auto-mapping-tool\test-systems\Jabref\sources\3.7\src\main\java\net\sf\jabref\model\entry\specialfields\SpecialField.java", "Java", 87, 0, 4, 21, 112
"c:\Users\zipasink\OneDrive\PhD\research\research-workspace\interactive-auto-mapping-tool\test-systems\Jabref\sources\3.7\src\main\java\net\sf\jabref\model\entry\specialfields\SpecialFieldValue.java", "Java", 31, 0, 5, 10, 46
"c:\Users\zipasink\OneDrive\PhD\research\research-workspace\interactive-auto-mapping-tool\test-systems\Jabref\sources\3.7\src\main\java\net\sf\jabref\model\groups\AbstractGroup.java", "Java", 68, 0, 86, 27, 181
"c:\Users\zipasink\OneDrive\PhD\research\research-workspace\interactive-auto-mapping-tool\test-systems\Jabref\sources\3.7\src\main\java\net\sf\jabref\model\groups\AllEntriesGroup.java", "Java", 54, 0, 7, 18, 79
"c:\Users\zipasink\OneDrive\PhD\research\research-workspace\interactive-auto-mapping-tool\test-systems\Jabref\sources\3.7\src\main\java\net\sf\jabref\model\groups\EntriesGroupChange.java", "Java", 32, 0, 0, 12, 44
"c:\Users\zipasink\OneDrive\PhD\research\research-workspace\interactive-auto-mapping-tool\test-systems\Jabref\sources\3.7\src\main\java\net\sf\jabref\model\groups\ExplicitGroup.java", "Java", 71, 0, 12, 21, 104
"c:\Users\zipasink\OneDrive\PhD\research\research-workspace\interactive-auto-mapping-tool\test-systems\Jabref\sources\3.7\src\main\java\net\sf\jabref\model\groups\GroupHierarchyType.java", "Java", 14, 0, 9, 6, 29
"c:\Users\zipasink\OneDrive\PhD\research\research-workspace\interactive-auto-mapping-tool\test-systems\Jabref\sources\3.7\src\main\java\net\sf\jabref\model\groups\GroupTreeNode.java", "Java", 152, 0, 64, 35, 251
"c:\Users\zipasink\OneDrive\PhD\research\research-workspace\interactive-auto-mapping-tool\test-systems\Jabref\sources\3.7\src\main\java\net\sf\jabref\model\groups\GroupsUtil.java", "Java", 54, 0, 16, 11, 81
"c:\Users\zipasink\OneDrive\PhD\research\research-workspace\interactive-auto-mapping-tool\test-systems\Jabref\sources\3.7\src\main\java\net\sf\jabref\model\groups\KeywordGroup.java", "Java", 232, 0, 27, 40, 299
"c:\Users\zipasink\OneDrive\PhD\research\research-workspace\interactive-auto-mapping-tool\test-systems\Jabref\sources\3.7\src\main\java\net\sf\jabref\model\groups\MoveGroupChange.java", "Java", 25, 0, 6, 9, 40
"c:\Users\zipasink\OneDrive\PhD\research\research-workspace\interactive-auto-mapping-tool\test-systems\Jabref\sources\3.7\src\main\java\net\sf\jabref\model\groups\SearchGroup.java", "Java", 103, 0, 15, 28, 146
"c:\Users\zipasink\OneDrive\PhD\research\research-workspace\interactive-auto-mapping-tool\test-systems\Jabref\sources\3.7\src\main\java\net\sf\jabref\model\groups\TreeNode.java", "Java", 247, 0, 300, 60, 607
"c:\Users\zipasink\OneDrive\PhD\research\research-workspace\interactive-auto-mapping-tool\test-systems\Jabref\sources\3.7\src\main\java\net\sf\jabref\model\groups\event\GroupUpdatedEvent.java", "Java", 12, 0, 3, 6, 21
"c:\Users\zipasink\OneDrive\PhD\research\research-workspace\interactive-auto-mapping-tool\test-systems\Jabref\sources\3.7\src\main\java\net\sf\jabref\model\metadata\FileDirectoryPreferences.java", "Java", 28, 0, 0, 10, 38
"c:\Users\zipasink\OneDrive\PhD\research\research-workspace\interactive-auto-mapping-tool\test-systems\Jabref\sources\3.7\src\main\java\net\sf\jabref\model\metadata\MetaData.java", "Java", 192, 0, 30, 47, 269
"c:\Users\zipasink\OneDrive\PhD\research\research-workspace\interactive-auto-mapping-tool\test-systems\Jabref\sources\3.7\src\main\java\net\sf\jabref\model\metadata\SaveOrderConfig.java", "Java", 144, 0, 10, 33, 187
"c:\Users\zipasink\OneDrive\PhD\research\research-workspace\interactive-auto-mapping-tool\test-systems\Jabref\sources\3.7\src\main\java\net\sf\jabref\model\metadata\event\MetaDataChangedEvent.java", "Java", 12, 0, 6, 6, 24
"c:\Users\zipasink\OneDrive\PhD\research\research-workspace\interactive-auto-mapping-tool\test-systems\Jabref\sources\3.7\src\main\java\net\sf\jabref\model\search\GroupSearchQuery.java", "Java", 46, 0, 0, 12, 58
"c:\Users\zipasink\OneDrive\PhD\research\research-workspace\interactive-auto-mapping-tool\test-systems\Jabref\sources\3.7\src\main\java\net\sf\jabref\model\search\SearchMatcher.java", "Java", 6, 0, 0, 5, 11
"c:\Users\zipasink\OneDrive\PhD\research\research-workspace\interactive-auto-mapping-tool\test-systems\Jabref\sources\3.7\src\main\java\net\sf\jabref\model\search\matchers\AndMatcher.java", "Java", 15, 0, 6, 6, 27
"c:\Users\zipasink\OneDrive\PhD\research\research-workspace\interactive-auto-mapping-tool\test-systems\Jabref\sources\3.7\src\main\java\net\sf\jabref\model\search\matchers\MatcherSet.java", "Java", 33, 0, 0, 13, 46
"c:\Users\zipasink\OneDrive\PhD\research\research-workspace\interactive-auto-mapping-tool\test-systems\Jabref\sources\3.7\src\main\java\net\sf\jabref\model\search\matchers\MatcherSets.java", "Java", 14, 0, 0, 6, 20
"c:\Users\zipasink\OneDrive\PhD\research\research-workspace\interactive-auto-mapping-tool\test-systems\Jabref\sources\3.7\src\main\java\net\sf\jabref\model\search\matchers\NotMatcher.java", "Java", 14, 0, 7, 7, 28
"c:\Users\zipasink\OneDrive\PhD\research\research-workspace\interactive-auto-mapping-tool\test-systems\Jabref\sources\3.7\src\main\java\net\sf\jabref\model\search\matchers\OrMatcher.java", "Java", 15, 0, 6, 6, 27
"c:\Users\zipasink\OneDrive\PhD\research\research-workspace\interactive-auto-mapping-tool\test-systems\Jabref\sources\3.7\src\main\java\net\sf\jabref\model\search\rules\ContainBasedSearchRule.java", "Java", 42, 0, 3, 16, 61
"c:\Users\zipasink\OneDrive\PhD\research\research-workspace\interactive-auto-mapping-tool\test-systems\Jabref\sources\3.7\src\main\java\net\sf\jabref\model\search\rules\GrammarBasedSearchRule.java", "Java", 196, 0, 13, 49, 258
"c:\Users\zipasink\OneDrive\PhD\research\research-workspace\interactive-auto-mapping-tool\test-systems\Jabref\sources\3.7\src\main\java\net\sf\jabref\model\search\rules\RegexBasedSearchRule.java", "Java", 48, 0, 3, 14, 65
"c:\Users\zipasink\OneDrive\PhD\research\research-workspace\interactive-auto-mapping-tool\test-systems\Jabref\sources\3.7\src\main\java\net\sf\jabref\model\search\rules\SearchRule.java", "Java", 6, 0, 0, 5, 11
"c:\Users\zipasink\OneDrive\PhD\research\research-workspace\interactive-auto-mapping-tool\test-systems\Jabref\sources\3.7\src\main\java\net\sf\jabref\model\search\rules\SearchRules.java", "Java", 22, 0, 5, 7, 34
"c:\Users\zipasink\OneDrive\PhD\research\research-workspace\interactive-auto-mapping-tool\test-systems\Jabref\sources\3.7\src\main\java\net\sf\jabref\model\search\rules\SentenceAnalyzer.java", "Java", 42, 0, 7, 9, 58
"c:\Users\zipasink\OneDrive\PhD\research\research-workspace\interactive-auto-mapping-tool\test-systems\Jabref\sources\3.7\src\main\java\net\sf\jabref\model\strings\HTMLUnicodeConversionMaps.java", "Java", 649, 0, 224, 32, 905
"c:\Users\zipasink\OneDrive\PhD\research\research-workspace\interactive-auto-mapping-tool\test-systems\Jabref\sources\3.7\src\main\java\net\sf\jabref\model\strings\LatexToUnicode.java", "Java", 151, 0, 34, 25, 210
"c:\Users\zipasink\OneDrive\PhD\research\research-workspace\interactive-auto-mapping-tool\test-systems\Jabref\sources\3.7\src\main\java\net\sf\jabref\model\strings\StringUtil.java", "Java", 413, 0, 209, 87, 709
"c:\Users\zipasink\OneDrive\PhD\research\research-workspace\interactive-auto-mapping-tool\test-systems\Jabref\sources\3.7\src\main\java\net\sf\jabref\model\strings\UnicodeToReadableCharMap.java", "Java", 234, 0, 1, 7, 242
"c:\Users\zipasink\OneDrive\PhD\research\research-workspace\interactive-auto-mapping-tool\test-systems\Jabref\sources\3.7\src\main\java\net\sf\jabref\pdfimport\ImportDialog.java", "Java", 202, 0, 3, 29, 234
"c:\Users\zipasink\OneDrive\PhD\research\research-workspace\interactive-auto-mapping-tool\test-systems\Jabref\sources\3.7\src\main\java\net\sf\jabref\pdfimport\PdfFileFilter.java", "Java", 20, 0, 0, 9, 29
"c:\Users\zipasink\OneDrive\PhD\research\research-workspace\interactive-auto-mapping-tool\test-systems\Jabref\sources\3.7\src\main\java\net\sf\jabref\pdfimport\PdfImporter.java", "Java", 209, 0, 40, 48, 297
"c:\Users\zipasink\OneDrive\PhD\research\research-workspace\interactive-auto-mapping-tool\test-systems\Jabref\sources\3.7\src\main\java\net\sf\jabref\preferences\CustomImportList.java", "Java", 53, 0, 17, 14, 84
"c:\Users\zipasink\OneDrive\PhD\research\research-workspace\interactive-auto-mapping-tool\test-systems\Jabref\sources\3.7\src\main\java\net\sf\jabref\preferences\HighlightMatchingGroupPreferences.java", "Java", 28, 0, 0, 12, 40
"c:\Users\zipasink\OneDrive\PhD\research\research-workspace\interactive-auto-mapping-tool\test-systems\Jabref\sources\3.7\src\main\java\net\sf\jabref\preferences\JabRefPreferences.java", "Java", 1192, 0, 176, 193, 1561
"c:\Users\zipasink\OneDrive\PhD\research\research-workspace\interactive-auto-mapping-tool\test-systems\Jabref\sources\3.7\src\main\java\net\sf\jabref\preferences\JabRefPreferencesFilter.java", "Java", 79, 0, 0, 23, 102
"c:\Users\zipasink\OneDrive\PhD\research\research-workspace\interactive-auto-mapping-tool\test-systems\Jabref\sources\3.7\src\main\java\net\sf\jabref\preferences\LastFocusedTabPreferences.java", "Java", 23, 0, 0, 9, 32
"c:\Users\zipasink\OneDrive\PhD\research\research-workspace\interactive-auto-mapping-tool\test-systems\Jabref\sources\3.7\src\main\java\net\sf\jabref\preferences\PreviewPreferences.java", "Java", 82, 0, 0, 25, 107
"c:\Users\zipasink\OneDrive\PhD\research\research-workspace\interactive-auto-mapping-tool\test-systems\Jabref\sources\3.7\src\main\java\net\sf\jabref\preferences\SearchPreferences.java", "Java", 88, 0, 1, 29, 118
"c:\Users\zipasink\OneDrive\PhD\research\research-workspace\interactive-auto-mapping-tool\test-systems\Jabref\sources\3.7\src\main\java\net\sf\jabref\preferences\VersionPreferences.java", "Java", 11, 0, 0, 8, 19
"c:\Users\zipasink\OneDrive\PhD\research\research-workspace\interactive-auto-mapping-tool\test-systems\Jabref\sources\3.7\src\main\java\net\sf\jabref\shared\DBMSConnection.java", "Java", 49, 0, 8, 17, 74
"c:\Users\zipasink\OneDrive\PhD\research\research-workspace\interactive-auto-mapping-tool\test-systems\Jabref\sources\3.7\src\main\java\net\sf\jabref\shared\DBMSConnectionProperties.java", "Java", 107, 0, 11, 29, 147
"c:\Users\zipasink\OneDrive\PhD\research\research-workspace\interactive-auto-mapping-tool\test-systems\Jabref\sources\3.7\src\main\java\net\sf\jabref\shared\DBMSProcessor.java", "Java", 392, 0, 129, 78, 599
"c:\Users\zipasink\OneDrive\PhD\research\research-workspace\interactive-auto-mapping-tool\test-systems\Jabref\sources\3.7\src\main\java\net\sf\jabref\shared\DBMSSynchronizer.java", "Java", 271, 0, 81, 42, 394
"c:\Users\zipasink\OneDrive\PhD\research\research-workspace\interactive-auto-mapping-tool\test-systems\Jabref\sources\3.7\src\main\java\net\sf\jabref\shared\DBMSType.java", "Java", 47, 0, 12, 13, 72
"c:\Users\zipasink\OneDrive\PhD\research\research-workspace\interactive-auto-mapping-tool\test-systems\Jabref\sources\3.7\src\main\java\net\sf\jabref\shared\MySQLProcessor.java", "Java", 29, 0, 8, 8, 45
"c:\Users\zipasink\OneDrive\PhD\research\research-workspace\interactive-auto-mapping-tool\test-systems\Jabref\sources\3.7\src\main\java\net\sf\jabref\shared\OracleProcessor.java", "Java", 78, 0, 10, 26, 114
"c:\Users\zipasink\OneDrive\PhD\research\research-workspace\interactive-auto-mapping-tool\test-systems\Jabref\sources\3.7\src\main\java\net\sf\jabref\shared\PostgreSQLProcessor.java", "Java", 95, 0, 13, 24, 132
"c:\Users\zipasink\OneDrive\PhD\research\research-workspace\interactive-auto-mapping-tool\test-systems\Jabref\sources\3.7\src\main\java\net\sf\jabref\shared\event\ConnectionLostEvent.java", "Java", 11, 0, 6, 6, 23
"c:\Users\zipasink\OneDrive\PhD\research\research-workspace\interactive-auto-mapping-tool\test-systems\Jabref\sources\3.7\src\main\java\net\sf\jabref\shared\event\SharedEntryNotPresentEvent.java", "Java", 11, 0, 7, 6, 24
"c:\Users\zipasink\OneDrive\PhD\research\research-workspace\interactive-auto-mapping-tool\test-systems\Jabref\sources\3.7\src\main\java\net\sf\jabref\shared\event\UpdateRefusedEvent.java", "Java", 22, 0, 8, 8, 38
"c:\Users\zipasink\OneDrive\PhD\research\research-workspace\interactive-auto-mapping-tool\test-systems\Jabref\sources\3.7\src\main\java\net\sf\jabref\shared\exception\DatabaseNotSupportedException.java", "Java", 6, 0, 3, 3, 12
"c:\Users\zipasink\OneDrive\PhD\research\research-workspace\interactive-auto-mapping-tool\test-systems\Jabref\sources\3.7\src\main\java\net\sf\jabref\shared\exception\InvalidDBMSConnectionPropertiesException.java", "Java", 6, 0, 3, 3, 12
"c:\Users\zipasink\OneDrive\PhD\research\research-workspace\interactive-auto-mapping-tool\test-systems\Jabref\sources\3.7\src\main\java\net\sf\jabref\shared\exception\NotASharedDatabaseException.java", "Java", 6, 0, 3, 4, 13
"c:\Users\zipasink\OneDrive\PhD\research\research-workspace\interactive-auto-mapping-tool\test-systems\Jabref\sources\3.7\src\main\java\net\sf\jabref\shared\exception\OfflineLockException.java", "Java", 17, 0, 4, 8, 29
"c:\Users\zipasink\OneDrive\PhD\research\research-workspace\interactive-auto-mapping-tool\test-systems\Jabref\sources\3.7\src\main\java\net\sf\jabref\shared\exception\SharedEntryNotPresentException.java", "Java", 12, 0, 3, 7, 22
"c:\Users\zipasink\OneDrive\PhD\research\research-workspace\interactive-auto-mapping-tool\test-systems\Jabref\sources\3.7\src\main\java\net\sf\jabref\shared\listener\OracleNotificationListener.java", "Java", 14, 0, 3, 7, 24
"c:\Users\zipasink\OneDrive\PhD\research\research-workspace\interactive-auto-mapping-tool\test-systems\Jabref\sources\3.7\src\main\java\net\sf\jabref\shared\listener\PostgresSQLNotificationListener.java", "Java", 16, 0, 3, 8, 27
"c:\Users\zipasink\OneDrive\PhD\research\research-workspace\interactive-auto-mapping-tool\test-systems\Jabref\sources\3.7\src\main\java\net\sf\jabref\shared\prefs\SharedDatabasePreferences.java", "Java", 98, 0, 4, 33, 135
"c:\Users\zipasink\OneDrive\PhD\research\research-workspace\interactive-auto-mapping-tool\test-systems\Jabref\sources\3.7\src\main\java\net\sf\jabref\shared\security\Password.java", "Java", 36, 0, 20, 10, 66
"c:\Users\zipasink\OneDrive\PhD\research\research-workspace\interactive-auto-mapping-tool\test-systems\Jabref\sources\3.7\src\main\java\osx\macadapter\MacAdapter.java", "Java", 68, 0, 15, 17, 100
"Total", "-", 88603, 886, 17170, 19379, 126038