"filename", "language", "Java", "Properties", "HTML", "XML", "comment", "blank", "total"
"c:\Users\zipasink\OneDrive\PhD\research\research-workspace\interactive-auto-mapping-tool\test-systems\ant\src\main\org\apache\tools\ant\AntClassLoader.java", "Java", 743, 0, 0, 0, 674, 133, 1550
"c:\Users\zipasink\OneDrive\PhD\research\research-workspace\interactive-auto-mapping-tool\test-systems\ant\src\main\org\apache\tools\ant\AntTypeDefinition.java", "Java", 193, 0, 0, 0, 150, 27, 370
"c:\Users\zipasink\OneDrive\PhD\research\research-workspace\interactive-auto-mapping-tool\test-systems\ant\src\main\org\apache\tools\ant\BuildEvent.java", "Java", 53, 0, 0, 0, 134, 15, 202
"c:\Users\zipasink\OneDrive\PhD\research\research-workspace\interactive-auto-mapping-tool\test-systems\ant\src\main\org\apache\tools\ant\BuildException.java", "Java", 69, 0, 0, 0, 121, 20, 210
"c:\Users\zipasink\OneDrive\PhD\research\research-workspace\interactive-auto-mapping-tool\test-systems\ant\src\main\org\apache\tools\ant\BuildListener.java", "Java", 11, 0, 0, 0, 85, 11, 107
"c:\Users\zipasink\OneDrive\PhD\research\research-workspace\interactive-auto-mapping-tool\test-systems\ant\src\main\org\apache\tools\ant\BuildLogger.java", "Java", 8, 0, 0, 0, 57, 8, 73
"c:\Users\zipasink\OneDrive\PhD\research\research-workspace\interactive-auto-mapping-tool\test-systems\ant\src\main\org\apache\tools\ant\ComponentHelper.java", "Java", 597, 0, 0, 0, 358, 73, 1028
"c:\Users\zipasink\OneDrive\PhD\research\research-workspace\interactive-auto-mapping-tool\test-systems\ant\src\main\org\apache\tools\ant\DefaultLogger.java", "Java", 144, 0, 0, 0, 155, 34, 333
"c:\Users\zipasink\OneDrive\PhD\research\research-workspace\interactive-auto-mapping-tool\test-systems\ant\src\main\org\apache\tools\ant\DemuxInputStream.java", "Java", 19, 0, 0, 0, 45, 10, 74
"c:\Users\zipasink\OneDrive\PhD\research\research-workspace\interactive-auto-mapping-tool\test-systems\ant\src\main\org\apache\tools\ant\DemuxOutputStream.java", "Java", 106, 0, 0, 0, 118, 25, 249
"c:\Users\zipasink\OneDrive\PhD\research\research-workspace\interactive-auto-mapping-tool\test-systems\ant\src\main\org\apache\tools\ant\Diagnostics.java", "Java", 415, 0, 0, 0, 176, 60, 651
"c:\Users\zipasink\OneDrive\PhD\research\research-workspace\interactive-auto-mapping-tool\test-systems\ant\src\main\org\apache\tools\ant\DirectoryScanner.java", "Java", 758, 0, 0, 0, 809, 121, 1688
"c:\Users\zipasink\OneDrive\PhD\research\research-workspace\interactive-auto-mapping-tool\test-systems\ant\src\main\org\apache\tools\ant\DynamicAttribute.java", "Java", 5, 0, 0, 0, 29, 5, 39
"c:\Users\zipasink\OneDrive\PhD\research\research-workspace\interactive-auto-mapping-tool\test-systems\ant\src\main\org\apache\tools\ant\DynamicAttributeNS.java", "Java", 6, 0, 0, 0, 32, 4, 42
"c:\Users\zipasink\OneDrive\PhD\research\research-workspace\interactive-auto-mapping-tool\test-systems\ant\src\main\org\apache\tools\ant\DynamicConfigurator.java", "Java", 4, 0, 0, 0, 22, 4, 30
"c:\Users\zipasink\OneDrive\PhD\research\research-workspace\interactive-auto-mapping-tool\test-systems\ant\src\main\org\apache\tools\ant\DynamicConfiguratorNS.java", "Java", 4, 0, 0, 0, 22, 2, 28
"c:\Users\zipasink\OneDrive\PhD\research\research-workspace\interactive-auto-mapping-tool\test-systems\ant\src\main\org\apache\tools\ant\DynamicElement.java", "Java", 4, 0, 0, 0, 29, 4, 37
"c:\Users\zipasink\OneDrive\PhD\research\research-workspace\interactive-auto-mapping-tool\test-systems\ant\src\main\org\apache\tools\ant\DynamicElementNS.java", "Java", 5, 0, 0, 0, 31, 2, 38
"c:\Users\zipasink\OneDrive\PhD\research\research-workspace\interactive-auto-mapping-tool\test-systems\ant\src\main\org\apache\tools\ant\Executor.java", "Java", 6, 0, 0, 0, 31, 6, 43
"c:\Users\zipasink\OneDrive\PhD\research\research-workspace\interactive-auto-mapping-tool\test-systems\ant\src\main\org\apache\tools\ant\ExitException.java", "Java", 15, 0, 0, 0, 39, 6, 60
"c:\Users\zipasink\OneDrive\PhD\research\research-workspace\interactive-auto-mapping-tool\test-systems\ant\src\main\org\apache\tools\ant\ExitStatusException.java", "Java", 19, 0, 0, 0, 42, 7, 68
"c:\Users\zipasink\OneDrive\PhD\research\research-workspace\interactive-auto-mapping-tool\test-systems\ant\src\main\org\apache\tools\ant\FileScanner.java", "Java", 18, 0, 0, 0, 125, 16, 159
"c:\Users\zipasink\OneDrive\PhD\research\research-workspace\interactive-auto-mapping-tool\test-systems\ant\src\main\org\apache\tools\ant\IntrospectionHelper.java", "Java", 819, 0, 0, 0, 571, 88, 1478
"c:\Users\zipasink\OneDrive\PhD\research\research-workspace\interactive-auto-mapping-tool\test-systems\ant\src\main\org\apache\tools\ant\Location.java", "Java", 65, 0, 0, 0, 92, 21, 178
"c:\Users\zipasink\OneDrive\PhD\research\research-workspace\interactive-auto-mapping-tool\test-systems\ant\src\main\org\apache\tools\ant\MagicNames.java", "Java", 30, 0, 0, 0, 117, 23, 170
"c:\Users\zipasink\OneDrive\PhD\research\research-workspace\interactive-auto-mapping-tool\test-systems\ant\src\main\org\apache\tools\ant\Main.java", "Java", 621, 0, 0, 0, 322, 101, 1044
"c:\Users\zipasink\OneDrive\PhD\research\research-workspace\interactive-auto-mapping-tool\test-systems\ant\src\main\org\apache\tools\ant\NoBannerLogger.java", "Java", 25, 0, 0, 0, 52, 12, 89
"c:\Users\zipasink\OneDrive\PhD\research\research-workspace\interactive-auto-mapping-tool\test-systems\ant\src\main\org\apache\tools\ant\PathTokenizer.java", "Java", 71, 0, 0, 0, 81, 14, 166
"c:\Users\zipasink\OneDrive\PhD\research\research-workspace\interactive-auto-mapping-tool\test-systems\ant\src\main\org\apache\tools\ant\Project.java", "Java", 930, 0, 0, 0, 1297, 164, 2391
"c:\Users\zipasink\OneDrive\PhD\research\research-workspace\interactive-auto-mapping-tool\test-systems\ant\src\main\org\apache\tools\ant\ProjectComponent.java", "Java", 44, 0, 0, 0, 111, 16, 171
"c:\Users\zipasink\OneDrive\PhD\research\research-workspace\interactive-auto-mapping-tool\test-systems\ant\src\main\org\apache\tools\ant\ProjectHelper.java", "Java", 208, 0, 0, 0, 290, 48, 546
"c:\Users\zipasink\OneDrive\PhD\research\research-workspace\interactive-auto-mapping-tool\test-systems\ant\src\main\org\apache\tools\ant\PropertyHelper.java", "Java", 257, 0, 0, 0, 311, 62, 630
"c:\Users\zipasink\OneDrive\PhD\research\research-workspace\interactive-auto-mapping-tool\test-systems\ant\src\main\org\apache\tools\ant\RuntimeConfigurable.java", "Java", 197, 0, 0, 0, 227, 52, 476
"c:\Users\zipasink\OneDrive\PhD\research\research-workspace\interactive-auto-mapping-tool\test-systems\ant\src\main\org\apache\tools\ant\SubBuildListener.java", "Java", 5, 0, 0, 0, 49, 5, 59
"c:\Users\zipasink\OneDrive\PhD\research\research-workspace\interactive-auto-mapping-tool\test-systems\ant\src\main\org\apache\tools\ant\Target.java", "Java", 188, 0, 0, 0, 230, 41, 459
"c:\Users\zipasink\OneDrive\PhD\research\research-workspace\interactive-auto-mapping-tool\test-systems\ant\src\main\org\apache\tools\ant\Task.java", "Java", 175, 0, 0, 0, 268, 40, 483
"c:\Users\zipasink\OneDrive\PhD\research\research-workspace\interactive-auto-mapping-tool\test-systems\ant\src\main\org\apache\tools\ant\TaskAdapter.java", "Java", 72, 0, 0, 0, 77, 13, 162
"c:\Users\zipasink\OneDrive\PhD\research\research-workspace\interactive-auto-mapping-tool\test-systems\ant\src\main\org\apache\tools\ant\TaskContainer.java", "Java", 4, 0, 0, 0, 35, 4, 43
"c:\Users\zipasink\OneDrive\PhD\research\research-workspace\interactive-auto-mapping-tool\test-systems\ant\src\main\org\apache\tools\ant\TypeAdapter.java", "Java", 8, 0, 0, 0, 51, 8, 67
"c:\Users\zipasink\OneDrive\PhD\research\research-workspace\interactive-auto-mapping-tool\test-systems\ant\src\main\org\apache\tools\ant\UnknownElement.java", "Java", 358, 0, 0, 0, 257, 58, 673
"c:\Users\zipasink\OneDrive\PhD\research\research-workspace\interactive-auto-mapping-tool\test-systems\ant\src\main\org\apache\tools\ant\UnsupportedAttributeException.java", "Java", 11, 0, 0, 0, 32, 6, 49
"c:\Users\zipasink\OneDrive\PhD\research\research-workspace\interactive-auto-mapping-tool\test-systems\ant\src\main\org\apache\tools\ant\UnsupportedElementException.java", "Java", 11, 0, 0, 0, 41, 5, 57
"c:\Users\zipasink\OneDrive\PhD\research\research-workspace\interactive-auto-mapping-tool\test-systems\ant\src\main\org\apache\tools\ant\XmlLogger.java", "Java", 270, 0, 0, 0, 175, 40, 485
"c:\Users\zipasink\OneDrive\PhD\research\research-workspace\interactive-auto-mapping-tool\test-systems\ant\src\main\org\apache\tools\ant\dispatch\DispatchTask.java", "Java", 14, 0, 0, 0, 40, 6, 60
"c:\Users\zipasink\OneDrive\PhD\research\research-workspace\interactive-auto-mapping-tool\test-systems\ant\src\main\org\apache\tools\ant\dispatch\DispatchUtils.java", "Java", 95, 0, 0, 0, 25, 4, 124
"c:\Users\zipasink\OneDrive\PhD\research\research-workspace\interactive-auto-mapping-tool\test-systems\ant\src\main\org\apache\tools\ant\dispatch\Dispatchable.java", "Java", 4, 0, 0, 0, 26, 2, 32
"c:\Users\zipasink\OneDrive\PhD\research\research-workspace\interactive-auto-mapping-tool\test-systems\ant\src\main\org\apache\tools\ant\filters\BaseFilterReader.java", "Java", 76, 0, 0, 0, 104, 19, 199
"c:\Users\zipasink\OneDrive\PhD\research\research-workspace\interactive-auto-mapping-tool\test-systems\ant\src\main\org\apache\tools\ant\filters\BaseParamFilterReader.java", "Java", 22, 0, 0, 0, 45, 7, 74
"c:\Users\zipasink\OneDrive\PhD\research\research-workspace\interactive-auto-mapping-tool\test-systems\ant\src\main\org\apache\tools\ant\filters\ChainableReader.java", "Java", 5, 0, 0, 0, 30, 3, 38
"c:\Users\zipasink\OneDrive\PhD\research\research-workspace\interactive-auto-mapping-tool\test-systems\ant\src\main\org\apache\tools\ant\filters\ClassConstants.java", "Java", 79, 0, 0, 0, 74, 12, 165
"c:\Users\zipasink\OneDrive\PhD\research\research-workspace\interactive-auto-mapping-tool\test-systems\ant\src\main\org\apache\tools\ant\filters\ConcatFilter.java", "Java", 92, 0, 0, 0, 105, 19, 216
"c:\Users\zipasink\OneDrive\PhD\research\research-workspace\interactive-auto-mapping-tool\test-systems\ant\src\main\org\apache\tools\ant\filters\EscapeUnicode.java", "Java", 50, 0, 0, 0, 69, 10, 129
"c:\Users\zipasink\OneDrive\PhD\research\research-workspace\interactive-auto-mapping-tool\test-systems\ant\src\main\org\apache\tools\ant\filters\ExpandProperties.java", "Java", 43, 0, 0, 0, 61, 10, 114
"c:\Users\zipasink\OneDrive\PhD\research\research-workspace\interactive-auto-mapping-tool\test-systems\ant\src\main\org\apache\tools\ant\filters\FixCrLfFilter.java", "Java", 571, 0, 0, 0, 311, 119, 1001
"c:\Users\zipasink\OneDrive\PhD\research\research-workspace\interactive-auto-mapping-tool\test-systems\ant\src\main\org\apache\tools\ant\filters\HeadFilter.java", "Java", 93, 0, 0, 0, 99, 23, 215
"c:\Users\zipasink\OneDrive\PhD\research\research-workspace\interactive-auto-mapping-tool\test-systems\ant\src\main\org\apache\tools\ant\filters\LineContains.java", "Java", 94, 0, 0, 0, 126, 24, 244
"c:\Users\zipasink\OneDrive\PhD\research\research-workspace\interactive-auto-mapping-tool\test-systems\ant\src\main\org\apache\tools\ant\filters\LineContainsRegExp.java", "Java", 92, 0, 0, 0, 111, 20, 223
"c:\Users\zipasink\OneDrive\PhD\research\research-workspace\interactive-auto-mapping-tool\test-systems\ant\src\main\org\apache\tools\ant\filters\PrefixLines.java", "Java", 68, 0, 0, 0, 81, 15, 164
"c:\Users\zipasink\OneDrive\PhD\research\research-workspace\interactive-auto-mapping-tool\test-systems\ant\src\main\org\apache\tools\ant\filters\ReplaceTokens.java", "Java", 190, 0, 0, 0, 146, 39, 375
"c:\Users\zipasink\OneDrive\PhD\research\research-workspace\interactive-auto-mapping-tool\test-systems\ant\src\main\org\apache\tools\ant\filters\StringInputStream.java", "Java", 11, 0, 0, 0, 32, 7, 50
"c:\Users\zipasink\OneDrive\PhD\research\research-workspace\interactive-auto-mapping-tool\test-systems\ant\src\main\org\apache\tools\ant\filters\StripJavaComments.java", "Java", 65, 0, 0, 0, 68, 13, 146
"c:\Users\zipasink\OneDrive\PhD\research\research-workspace\interactive-auto-mapping-tool\test-systems\ant\src\main\org\apache\tools\ant\filters\StripLineBreaks.java", "Java", 59, 0, 0, 0, 82, 13, 154
"c:\Users\zipasink\OneDrive\PhD\research\research-workspace\interactive-auto-mapping-tool\test-systems\ant\src\main\org\apache\tools\ant\filters\StripLineComments.java", "Java", 88, 0, 0, 0, 113, 23, 224
"c:\Users\zipasink\OneDrive\PhD\research\research-workspace\interactive-auto-mapping-tool\test-systems\ant\src\main\org\apache\tools\ant\filters\TabsToSpaces.java", "Java", 62, 0, 0, 0, 79, 15, 156
"c:\Users\zipasink\OneDrive\PhD\research\research-workspace\interactive-auto-mapping-tool\test-systems\ant\src\main\org\apache\tools\ant\filters\TailFilter.java", "Java", 114, 0, 0, 0, 106, 23, 243
"c:\Users\zipasink\OneDrive\PhD\research\research-workspace\interactive-auto-mapping-tool\test-systems\ant\src\main\org\apache\tools\ant\filters\TokenFilter.java", "Java", 350, 0, 0, 0, 297, 75, 722
"c:\Users\zipasink\OneDrive\PhD\research\research-workspace\interactive-auto-mapping-tool\test-systems\ant\src\main\org\apache\tools\ant\filters\util\ChainReaderHelper.java", "Java", 143, 0, 0, 0, 74, 21, 238
"c:\Users\zipasink\OneDrive\PhD\research\research-workspace\interactive-auto-mapping-tool\test-systems\ant\src\main\org\apache\tools\ant\filters\util\JavaClassHelper.java", "Java", 35, 0, 0, 0, 31, 4, 70
"c:\Users\zipasink\OneDrive\PhD\research\research-workspace\interactive-auto-mapping-tool\test-systems\ant\src\main\org\apache\tools\ant\helper\AntXMLContext.java", "Java", 141, 0, 0, 0, 177, 50, 368
"c:\Users\zipasink\OneDrive\PhD\research\research-workspace\interactive-auto-mapping-tool\test-systems\ant\src\main\org\apache\tools\ant\helper\DefaultExecutor.java", "Java", 28, 0, 0, 0, 25, 8, 61
"c:\Users\zipasink\OneDrive\PhD\research\research-workspace\interactive-auto-mapping-tool\test-systems\ant\src\main\org\apache\tools\ant\helper\ProjectHelper2.java", "Java", 575, 0, 0, 0, 449, 98, 1122
"c:\Users\zipasink\OneDrive\PhD\research\research-workspace\interactive-auto-mapping-tool\test-systems\ant\src\main\org\apache\tools\ant\helper\ProjectHelperImpl.java", "Java", 457, 0, 0, 0, 493, 87, 1037
"c:\Users\zipasink\OneDrive\PhD\research\research-workspace\interactive-auto-mapping-tool\test-systems\ant\src\main\org\apache\tools\ant\helper\SingleCheckExecutor.java", "Java", 14, 0, 0, 0, 25, 9, 48
"c:\Users\zipasink\OneDrive\PhD\research\research-workspace\interactive-auto-mapping-tool\test-systems\ant\src\main\org\apache\tools\ant\input\DefaultInputHandler.java", "Java", 71, 0, 0, 0, 45, 9, 125
"c:\Users\zipasink\OneDrive\PhD\research\research-workspace\interactive-auto-mapping-tool\test-systems\ant\src\main\org\apache\tools\ant\input\GreedyInputHandler.java", "Java", 43, 0, 0, 0, 32, 7, 82
"c:\Users\zipasink\OneDrive\PhD\research\research-workspace\interactive-auto-mapping-tool\test-systems\ant\src\main\org\apache\tools\ant\input\InputHandler.java", "Java", 5, 0, 0, 0, 33, 4, 42
"c:\Users\zipasink\OneDrive\PhD\research\research-workspace\interactive-auto-mapping-tool\test-systems\ant\src\main\org\apache\tools\ant\input\InputRequest.java", "Java", 30, 0, 0, 0, 52, 12, 94
"c:\Users\zipasink\OneDrive\PhD\research\research-workspace\interactive-auto-mapping-tool\test-systems\ant\src\main\org\apache\tools\ant\input\MultipleChoiceInputRequest.java", "Java", 18, 0, 0, 0, 33, 7, 58
"c:\Users\zipasink\OneDrive\PhD\research\research-workspace\interactive-auto-mapping-tool\test-systems\ant\src\main\org\apache\tools\ant\input\PropertyFileInputHandler.java", "Java", 41, 0, 0, 0, 39, 12, 92
"c:\Users\zipasink\OneDrive\PhD\research\research-workspace\interactive-auto-mapping-tool\test-systems\ant\src\main\org\apache\tools\ant\launch\AntMain.java", "Java", 6, 0, 0, 0, 33, 4, 43
"c:\Users\zipasink\OneDrive\PhD\research\research-workspace\interactive-auto-mapping-tool\test-systems\ant\src\main\org\apache\tools\ant\launch\LaunchException.java", "Java", 6, 0, 0, 0, 28, 4, 38
"c:\Users\zipasink\OneDrive\PhD\research\research-workspace\interactive-auto-mapping-tool\test-systems\ant\src\main\org\apache\tools\ant\launch\Launcher.java", "Java", 199, 0, 0, 0, 111, 41, 351
"c:\Users\zipasink\OneDrive\PhD\research\research-workspace\interactive-auto-mapping-tool\test-systems\ant\src\main\org\apache\tools\ant\launch\Locator.java", "Java", 277, 0, 0, 0, 161, 19, 457
"c:\Users\zipasink\OneDrive\PhD\research\research-workspace\interactive-auto-mapping-tool\test-systems\ant\src\main\org\apache\tools\ant\listener\AnsiColorLogger.java", "Java", 112, 0, 0, 0, 116, 16, 244
"c:\Users\zipasink\OneDrive\PhD\research\research-workspace\interactive-auto-mapping-tool\test-systems\ant\src\main\org\apache\tools\ant\listener\CommonsLoggingListener.java", "Java", 205, 0, 0, 0, 95, 33, 333
"c:\Users\zipasink\OneDrive\PhD\research\research-workspace\interactive-auto-mapping-tool\test-systems\ant\src\main\org\apache\tools\ant\listener\Log4jListener.java", "Java", 108, 0, 0, 0, 56, 16, 180
"c:\Users\zipasink\OneDrive\PhD\research\research-workspace\interactive-auto-mapping-tool\test-systems\ant\src\main\org\apache\tools\ant\listener\MailLogger.java", "Java", 160, 0, 0, 0, 97, 27, 284
"c:\Users\zipasink\OneDrive\PhD\research\research-workspace\interactive-auto-mapping-tool\test-systems\ant\src\main\org\apache\tools\ant\listener\TimestampedLogger.java", "Java", 19, 0, 0, 0, 39, 10, 68
"c:\Users\zipasink\OneDrive\PhD\research\research-workspace\interactive-auto-mapping-tool\test-systems\ant\src\main\org\apache\tools\ant\listener\defaults.properties", "Properties", 0, 5, 0, 0, 37, 2, 44
"c:\Users\zipasink\OneDrive\PhD\research\research-workspace\interactive-auto-mapping-tool\test-systems\ant\src\main\org\apache\tools\ant\loader\AntClassLoader2.java", "Java", 6, 0, 0, 0, 22, 4, 32
"c:\Users\zipasink\OneDrive\PhD\research\research-workspace\interactive-auto-mapping-tool\test-systems\ant\src\main\org\apache\tools\ant\taskdefs\AbstractCvsTask.java", "Java", 369, 0, 0, 0, 329, 105, 803
"c:\Users\zipasink\OneDrive\PhD\research\research-workspace\interactive-auto-mapping-tool\test-systems\ant\src\main\org\apache\tools\ant\taskdefs\AbstractJarSignerTask.java", "Java", 154, 0, 0, 0, 188, 38, 380
"c:\Users\zipasink\OneDrive\PhD\research\research-workspace\interactive-auto-mapping-tool\test-systems\ant\src\main\org\apache\tools\ant\taskdefs\Ant.java", "Java", 422, 0, 0, 0, 280, 82, 784
"c:\Users\zipasink\OneDrive\PhD\research\research-workspace\interactive-auto-mapping-tool\test-systems\ant\src\main\org\apache\tools\ant\taskdefs\AntStructure.java", "Java", 300, 0, 0, 0, 121, 49, 470
"c:\Users\zipasink\OneDrive\PhD\research\research-workspace\interactive-auto-mapping-tool\test-systems\ant\src\main\org\apache\tools\ant\taskdefs\Antlib.java", "Java", 87, 0, 0, 0, 63, 16, 166
"c:\Users\zipasink\OneDrive\PhD\research\research-workspace\interactive-auto-mapping-tool\test-systems\ant\src\main\org\apache\tools\ant\taskdefs\AntlibDefinition.java", "Java", 26, 0, 0, 0, 47, 9, 82
"c:\Users\zipasink\OneDrive\PhD\research\research-workspace\interactive-auto-mapping-tool\test-systems\ant\src\main\org\apache\tools\ant\taskdefs\Apt.java", "Java", 103, 0, 0, 0, 133, 30, 266
"c:\Users\zipasink\OneDrive\PhD\research\research-workspace\interactive-auto-mapping-tool\test-systems\ant\src\main\org\apache\tools\ant\taskdefs\Available.java", "Java", 292, 0, 0, 0, 178, 33, 503
"c:\Users\zipasink\OneDrive\PhD\research\research-workspace\interactive-auto-mapping-tool\test-systems\ant\src\main\org\apache\tools\ant\taskdefs\BUnzip2.java", "Java", 55, 0, 0, 0, 44, 11, 110
"c:\Users\zipasink\OneDrive\PhD\research\research-workspace\interactive-auto-mapping-tool\test-systems\ant\src\main\org\apache\tools\ant\taskdefs\BZip2.java", "Java", 28, 0, 0, 0, 39, 7, 74
"c:\Users\zipasink\OneDrive\PhD\research\research-workspace\interactive-auto-mapping-tool\test-systems\ant\src\main\org\apache\tools\ant\taskdefs\Basename.java", "Java", 36, 0, 0, 0, 64, 10, 110
"c:\Users\zipasink\OneDrive\PhD\research\research-workspace\interactive-auto-mapping-tool\test-systems\ant\src\main\org\apache\tools\ant\taskdefs\BuildNumber.java", "Java", 104, 0, 0, 0, 65, 32, 201
"c:\Users\zipasink\OneDrive\PhD\research\research-workspace\interactive-auto-mapping-tool\test-systems\ant\src\main\org\apache\tools\ant\taskdefs\CVSPass.java", "Java", 98, 0, 0, 0, 53, 21, 172
"c:\Users\zipasink\OneDrive\PhD\research\research-workspace\interactive-auto-mapping-tool\test-systems\ant\src\main\org\apache\tools\ant\taskdefs\CallTarget.java", "Java", 102, 0, 0, 0, 133, 21, 256
"c:\Users\zipasink\OneDrive\PhD\research\research-workspace\interactive-auto-mapping-tool\test-systems\ant\src\main\org\apache\tools\ant\taskdefs\Checksum.java", "Java", 411, 0, 0, 0, 232, 44, 687
"c:\Users\zipasink\OneDrive\PhD\research\research-workspace\interactive-auto-mapping-tool\test-systems\ant\src\main\org\apache\tools\ant\taskdefs\Chmod.java", "Java", 112, 0, 0, 0, 124, 24, 260
"c:\Users\zipasink\OneDrive\PhD\research\research-workspace\interactive-auto-mapping-tool\test-systems\ant\src\main\org\apache\tools\ant\taskdefs\Classloader.java", "Java", 107, 0, 0, 0, 106, 29, 242
"c:\Users\zipasink\OneDrive\PhD\research\research-workspace\interactive-auto-mapping-tool\test-systems\ant\src\main\org\apache\tools\ant\taskdefs\Concat.java", "Java", 564, 0, 0, 0, 264, 71, 899
"c:\Users\zipasink\OneDrive\PhD\research\research-workspace\interactive-auto-mapping-tool\test-systems\ant\src\main\org\apache\tools\ant\taskdefs\ConditionTask.java", "Java", 49, 0, 0, 0, 57, 10, 116
"c:\Users\zipasink\OneDrive\PhD\research\research-workspace\interactive-auto-mapping-tool\test-systems\ant\src\main\org\apache\tools\ant\taskdefs\Copy.java", "Java", 618, 0, 0, 0, 322, 76, 1016
"c:\Users\zipasink\OneDrive\PhD\research\research-workspace\interactive-auto-mapping-tool\test-systems\ant\src\main\org\apache\tools\ant\taskdefs\CopyPath.java", "Java", 96, 0, 0, 0, 82, 29, 207
"c:\Users\zipasink\OneDrive\PhD\research\research-workspace\interactive-auto-mapping-tool\test-systems\ant\src\main\org\apache\tools\ant\taskdefs\Copydir.java", "Java", 91, 0, 0, 0, 54, 19, 164
"c:\Users\zipasink\OneDrive\PhD\research\research-workspace\interactive-auto-mapping-tool\test-systems\ant\src\main\org\apache\tools\ant\taskdefs\Copyfile.java", "Java", 52, 0, 0, 0, 48, 16, 116
"c:\Users\zipasink\OneDrive\PhD\research\research-workspace\interactive-auto-mapping-tool\test-systems\ant\src\main\org\apache\tools\ant\taskdefs\Cvs.java", "Java", 5, 0, 0, 0, 33, 4, 42
"c:\Users\zipasink\OneDrive\PhD\research\research-workspace\interactive-auto-mapping-tool\test-systems\ant\src\main\org\apache\tools\ant\taskdefs\DefBase.java", "Java", 63, 0, 0, 0, 88, 17, 168
"c:\Users\zipasink\OneDrive\PhD\research\research-workspace\interactive-auto-mapping-tool\test-systems\ant\src\main\org\apache\tools\ant\taskdefs\DefaultExcludes.java", "Java", 53, 0, 0, 0, 52, 11, 116
"c:\Users\zipasink\OneDrive\PhD\research\research-workspace\interactive-auto-mapping-tool\test-systems\ant\src\main\org\apache\tools\ant\taskdefs\Definer.java", "Java", 377, 0, 0, 0, 211, 53, 641
"c:\Users\zipasink\OneDrive\PhD\research\research-workspace\interactive-auto-mapping-tool\test-systems\ant\src\main\org\apache\tools\ant\taskdefs\Delete.java", "Java", 423, 0, 0, 0, 252, 62, 737
"c:\Users\zipasink\OneDrive\PhD\research\research-workspace\interactive-auto-mapping-tool\test-systems\ant\src\main\org\apache\tools\ant\taskdefs\Deltree.java", "Java", 54, 0, 0, 0, 42, 16, 112
"c:\Users\zipasink\OneDrive\PhD\research\research-workspace\interactive-auto-mapping-tool\test-systems\ant\src\main\org\apache\tools\ant\taskdefs\DependSet.java", "Java", 138, 0, 0, 0, 89, 20, 247
"c:\Users\zipasink\OneDrive\PhD\research\research-workspace\interactive-auto-mapping-tool\test-systems\ant\src\main\org\apache\tools\ant\taskdefs\DiagnosticsTask.java", "Java", 10, 0, 0, 0, 26, 8, 44
"c:\Users\zipasink\OneDrive\PhD\research\research-workspace\interactive-auto-mapping-tool\test-systems\ant\src\main\org\apache\tools\ant\taskdefs\Dirname.java", "Java", 25, 0, 0, 0, 49, 10, 84
"c:\Users\zipasink\OneDrive\PhD\research\research-workspace\interactive-auto-mapping-tool\test-systems\ant\src\main\org\apache\tools\ant\taskdefs\Ear.java", "Java", 67, 0, 0, 0, 69, 15, 151
"c:\Users\zipasink\OneDrive\PhD\research\research-workspace\interactive-auto-mapping-tool\test-systems\ant\src\main\org\apache\tools\ant\taskdefs\Echo.java", "Java", 62, 0, 0, 0, 74, 14, 150
"c:\Users\zipasink\OneDrive\PhD\research\research-workspace\interactive-auto-mapping-tool\test-systems\ant\src\main\org\apache\tools\ant\taskdefs\EchoXML.java", "Java", 44, 0, 0, 0, 40, 10, 94
"c:\Users\zipasink\OneDrive\PhD\research\research-workspace\interactive-auto-mapping-tool\test-systems\ant\src\main\org\apache\tools\ant\taskdefs\Exec.java", "Java", 156, 0, 0, 0, 90, 35, 281
"c:\Users\zipasink\OneDrive\PhD\research\research-workspace\interactive-auto-mapping-tool\test-systems\ant\src\main\org\apache\tools\ant\taskdefs\ExecTask.java", "Java", 341, 0, 0, 0, 309, 60, 710
"c:\Users\zipasink\OneDrive\PhD\research\research-workspace\interactive-auto-mapping-tool\test-systems\ant\src\main\org\apache\tools\ant\taskdefs\Execute.java", "Java", 660, 0, 0, 0, 483, 88, 1231
"c:\Users\zipasink\OneDrive\PhD\research\research-workspace\interactive-auto-mapping-tool\test-systems\ant\src\main\org\apache\tools\ant\taskdefs\ExecuteJava.java", "Java", 213, 0, 0, 0, 99, 19, 331
"c:\Users\zipasink\OneDrive\PhD\research\research-workspace\interactive-auto-mapping-tool\test-systems\ant\src\main\org\apache\tools\ant\taskdefs\ExecuteOn.java", "Java", 432, 0, 0, 0, 245, 66, 743
"c:\Users\zipasink\OneDrive\PhD\research\research-workspace\interactive-auto-mapping-tool\test-systems\ant\src\main\org\apache\tools\ant\taskdefs\ExecuteStreamHandler.java", "Java", 11, 0, 0, 0, 49, 9, 69
"c:\Users\zipasink\OneDrive\PhD\research\research-workspace\interactive-auto-mapping-tool\test-systems\ant\src\main\org\apache\tools\ant\taskdefs\ExecuteWatchdog.java", "Java", 67, 0, 0, 0, 92, 19, 178
"c:\Users\zipasink\OneDrive\PhD\research\research-workspace\interactive-auto-mapping-tool\test-systems\ant\src\main\org\apache\tools\ant\taskdefs\Exit.java", "Java", 104, 0, 0, 0, 94, 20, 218
"c:\Users\zipasink\OneDrive\PhD\research\research-workspace\interactive-auto-mapping-tool\test-systems\ant\src\main\org\apache\tools\ant\taskdefs\Expand.java", "Java", 240, 0, 0, 0, 113, 42, 395
"c:\Users\zipasink\OneDrive\PhD\research\research-workspace\interactive-auto-mapping-tool\test-systems\ant\src\main\org\apache\tools\ant\taskdefs\Filter.java", "Java", 40, 0, 0, 0, 48, 13, 101
"c:\Users\zipasink\OneDrive\PhD\research\research-workspace\interactive-auto-mapping-tool\test-systems\ant\src\main\org\apache\tools\ant\taskdefs\FixCRLF.java", "Java", 374, 0, 0, 0, 230, 78, 682
"c:\Users\zipasink\OneDrive\PhD\research\research-workspace\interactive-auto-mapping-tool\test-systems\ant\src\main\org\apache\tools\ant\taskdefs\GUnzip.java", "Java", 43, 0, 0, 0, 44, 10, 97
"c:\Users\zipasink\OneDrive\PhD\research\research-workspace\interactive-auto-mapping-tool\test-systems\ant\src\main\org\apache\tools\ant\taskdefs\GZip.java", "Java", 23, 0, 0, 0, 39, 6, 68
"c:\Users\zipasink\OneDrive\PhD\research\research-workspace\interactive-auto-mapping-tool\test-systems\ant\src\main\org\apache\tools\ant\taskdefs\GenerateKey.java", "Java", 216, 0, 0, 0, 144, 60, 420
"c:\Users\zipasink\OneDrive\PhD\research\research-workspace\interactive-auto-mapping-tool\test-systems\ant\src\main\org\apache\tools\ant\taskdefs\Get.java", "Java", 214, 0, 0, 0, 175, 52, 441
"c:\Users\zipasink\OneDrive\PhD\research\research-workspace\interactive-auto-mapping-tool\test-systems\ant\src\main\org\apache\tools\ant\taskdefs\ImportTask.java", "Java", 69, 0, 0, 0, 64, 21, 154
"c:\Users\zipasink\OneDrive\PhD\research\research-workspace\interactive-auto-mapping-tool\test-systems\ant\src\main\org\apache\tools\ant\taskdefs\Input.java", "Java", 134, 0, 0, 0, 98, 25, 257
"c:\Users\zipasink\OneDrive\PhD\research\research-workspace\interactive-auto-mapping-tool\test-systems\ant\src\main\org\apache\tools\ant\taskdefs\JDBCTask.java", "Java", 199, 0, 0, 0, 219, 55, 473
"c:\Users\zipasink\OneDrive\PhD\research\research-workspace\interactive-auto-mapping-tool\test-systems\ant\src\main\org\apache\tools\ant\taskdefs\Jar.java", "Java", 558, 0, 0, 0, 338, 90, 986
"c:\Users\zipasink\OneDrive\PhD\research\research-workspace\interactive-auto-mapping-tool\test-systems\ant\src\main\org\apache\tools\ant\taskdefs\Java.java", "Java", 469, 0, 0, 0, 400, 71, 940
"c:\Users\zipasink\OneDrive\PhD\research\research-workspace\interactive-auto-mapping-tool\test-systems\ant\src\main\org\apache\tools\ant\taskdefs\Javac.java", "Java", 466, 0, 0, 0, 451, 107, 1024
"c:\Users\zipasink\OneDrive\PhD\research\research-workspace\interactive-auto-mapping-tool\test-systems\ant\src\main\org\apache\tools\ant\taskdefs\Javadoc.java", "Java", 1292, 0, 0, 0, 873, 209, 2374
"c:\Users\zipasink\OneDrive\PhD\research\research-workspace\interactive-auto-mapping-tool\test-systems\ant\src\main\org\apache\tools\ant\taskdefs\Jikes.java", "Java", 70, 0, 0, 0, 48, 13, 131
"c:\Users\zipasink\OneDrive\PhD\research\research-workspace\interactive-auto-mapping-tool\test-systems\ant\src\main\org\apache\tools\ant\taskdefs\JikesOutputParser.java", "Java", 84, 0, 0, 0, 79, 20, 183
"c:\Users\zipasink\OneDrive\PhD\research\research-workspace\interactive-auto-mapping-tool\test-systems\ant\src\main\org\apache\tools\ant\taskdefs\KeySubst.java", "Java", 117, 0, 0, 0, 70, 13, 200
"c:\Users\zipasink\OneDrive\PhD\research\research-workspace\interactive-auto-mapping-tool\test-systems\ant\src\main\org\apache\tools\ant\taskdefs\Length.java", "Java", 206, 0, 0, 0, 88, 36, 330
"c:\Users\zipasink\OneDrive\PhD\research\research-workspace\interactive-auto-mapping-tool\test-systems\ant\src\main\org\apache\tools\ant\taskdefs\LoadFile.java", "Java", 8, 0, 0, 0, 28, 5, 41
"c:\Users\zipasink\OneDrive\PhD\research\research-workspace\interactive-auto-mapping-tool\test-systems\ant\src\main\org\apache\tools\ant\taskdefs\LoadProperties.java", "Java", 123, 0, 0, 0, 86, 25, 234
"c:\Users\zipasink\OneDrive\PhD\research\research-workspace\interactive-auto-mapping-tool\test-systems\ant\src\main\org\apache\tools\ant\taskdefs\LoadResource.java", "Java", 126, 0, 0, 0, 84, 23, 233
"c:\Users\zipasink\OneDrive\PhD\research\research-workspace\interactive-auto-mapping-tool\test-systems\ant\src\main\org\apache\tools\ant\taskdefs\LogOutputStream.java", "Java", 33, 0, 0, 0, 56, 13, 102
"c:\Users\zipasink\OneDrive\PhD\research\research-workspace\interactive-auto-mapping-tool\test-systems\ant\src\main\org\apache\tools\ant\taskdefs\LogStreamHandler.java", "Java", 23, 0, 0, 0, 40, 7, 70
"c:\Users\zipasink\OneDrive\PhD\research\research-workspace\interactive-auto-mapping-tool\test-systems\ant\src\main\org\apache\tools\ant\taskdefs\MacroDef.java", "Java", 436, 0, 0, 0, 312, 74, 822
"c:\Users\zipasink\OneDrive\PhD\research\research-workspace\interactive-auto-mapping-tool\test-systems\ant\src\main\org\apache\tools\ant\taskdefs\MacroInstance.java", "Java", 309, 0, 0, 0, 72, 25, 406
"c:\Users\zipasink\OneDrive\PhD\research\research-workspace\interactive-auto-mapping-tool\test-systems\ant\src\main\org\apache\tools\ant\taskdefs\MakeUrl.java", "Java", 140, 0, 0, 0, 129, 29, 298
"c:\Users\zipasink\OneDrive\PhD\research\research-workspace\interactive-auto-mapping-tool\test-systems\ant\src\main\org\apache\tools\ant\taskdefs\Manifest.java", "Java", 572, 0, 0, 0, 398, 106, 1076
"c:\Users\zipasink\OneDrive\PhD\research\research-workspace\interactive-auto-mapping-tool\test-systems\ant\src\main\org\apache\tools\ant\taskdefs\ManifestClassPath.java", "Java", 98, 0, 0, 0, 68, 22, 188
"c:\Users\zipasink\OneDrive\PhD\research\research-workspace\interactive-auto-mapping-tool\test-systems\ant\src\main\org\apache\tools\ant\taskdefs\ManifestException.java", "Java", 6, 0, 0, 0, 26, 3, 35
"c:\Users\zipasink\OneDrive\PhD\research\research-workspace\interactive-auto-mapping-tool\test-systems\ant\src\main\org\apache\tools\ant\taskdefs\ManifestTask.java", "Java", 111, 0, 0, 0, 82, 24, 217
"c:\Users\zipasink\OneDrive\PhD\research\research-workspace\interactive-auto-mapping-tool\test-systems\ant\src\main\org\apache\tools\ant\taskdefs\MatchingTask.java", "Java", 171, 0, 0, 0, 229, 46, 446
"c:\Users\zipasink\OneDrive\PhD\research\research-workspace\interactive-auto-mapping-tool\test-systems\ant\src\main\org\apache\tools\ant\taskdefs\Mkdir.java", "Java", 45, 0, 0, 0, 43, 11, 99
"c:\Users\zipasink\OneDrive\PhD\research\research-workspace\interactive-auto-mapping-tool\test-systems\ant\src\main\org\apache\tools\ant\taskdefs\Move.java", "Java", 250, 0, 0, 0, 103, 34, 387
"c:\Users\zipasink\OneDrive\PhD\research\research-workspace\interactive-auto-mapping-tool\test-systems\ant\src\main\org\apache\tools\ant\taskdefs\Nice.java", "Java", 35, 0, 0, 0, 52, 13, 100
"c:\Users\zipasink\OneDrive\PhD\research\research-workspace\interactive-auto-mapping-tool\test-systems\ant\src\main\org\apache\tools\ant\taskdefs\Pack.java", "Java", 99, 0, 0, 0, 85, 22, 206
"c:\Users\zipasink\OneDrive\PhD\research\research-workspace\interactive-auto-mapping-tool\test-systems\ant\src\main\org\apache\tools\ant\taskdefs\Parallel.java", "Java", 233, 0, 0, 0, 174, 53, 460
"c:\Users\zipasink\OneDrive\PhD\research\research-workspace\interactive-auto-mapping-tool\test-systems\ant\src\main\org\apache\tools\ant\taskdefs\Patch.java", "Java", 94, 0, 0, 0, 75, 19, 188
"c:\Users\zipasink\OneDrive\PhD\research\research-workspace\interactive-auto-mapping-tool\test-systems\ant\src\main\org\apache\tools\ant\taskdefs\PathConvert.java", "Java", 220, 0, 0, 0, 212, 56, 488
"c:\Users\zipasink\OneDrive\PhD\research\research-workspace\interactive-auto-mapping-tool\test-systems\ant\src\main\org\apache\tools\ant\taskdefs\PreSetDef.java", "Java", 112, 0, 0, 0, 133, 31, 276
"c:\Users\zipasink\OneDrive\PhD\research\research-workspace\interactive-auto-mapping-tool\test-systems\ant\src\main\org\apache\tools\ant\taskdefs\ProcessDestroyer.java", "Java", 121, 0, 0, 0, 84, 17, 222
"c:\Users\zipasink\OneDrive\PhD\research\research-workspace\interactive-auto-mapping-tool\test-systems\ant\src\main\org\apache\tools\ant\taskdefs\Property.java", "Java", 329, 0, 0, 0, 253, 60, 642
"c:\Users\zipasink\OneDrive\PhD\research\research-workspace\interactive-auto-mapping-tool\test-systems\ant\src\main\org\apache\tools\ant\taskdefs\PumpStreamHandler.java", "Java", 103, 0, 0, 0, 105, 25, 233
"c:\Users\zipasink\OneDrive\PhD\research\research-workspace\interactive-auto-mapping-tool\test-systems\ant\src\main\org\apache\tools\ant\taskdefs\Recorder.java", "Java", 110, 0, 0, 0, 163, 41, 314
"c:\Users\zipasink\OneDrive\PhD\research\research-workspace\interactive-auto-mapping-tool\test-systems\ant\src\main\org\apache\tools\ant\taskdefs\RecorderEntry.java", "Java", 166, 0, 0, 0, 142, 49, 357
"c:\Users\zipasink\OneDrive\PhD\research\research-workspace\interactive-auto-mapping-tool\test-systems\ant\src\main\org\apache\tools\ant\taskdefs\Redirector.java", "Java", 436, 0, 0, 0, 297, 94, 827
"c:\Users\zipasink\OneDrive\PhD\research\research-workspace\interactive-auto-mapping-tool\test-systems\ant\src\main\org\apache\tools\ant\taskdefs\Rename.java", "Java", 40, 0, 0, 0, 40, 16, 96
"c:\Users\zipasink\OneDrive\PhD\research\research-workspace\interactive-auto-mapping-tool\test-systems\ant\src\main\org\apache\tools\ant\taskdefs\Replace.java", "Java", 445, 0, 0, 0, 294, 93, 832
"c:\Users\zipasink\OneDrive\PhD\research\research-workspace\interactive-auto-mapping-tool\test-systems\ant\src\main\org\apache\tools\ant\taskdefs\ResourceCount.java", "Java", 59, 0, 0, 0, 52, 14, 125
"c:\Users\zipasink\OneDrive\PhD\research\research-workspace\interactive-auto-mapping-tool\test-systems\ant\src\main\org\apache\tools\ant\taskdefs\Rmic.java", "Java", 347, 0, 0, 0, 318, 79, 744
"c:\Users\zipasink\OneDrive\PhD\research\research-workspace\interactive-auto-mapping-tool\test-systems\ant\src\main\org\apache\tools\ant\taskdefs\SQLExec.java", "Java", 412, 0, 0, 0, 296, 82, 790
"c:\Users\zipasink\OneDrive\PhD\research\research-workspace\interactive-auto-mapping-tool\test-systems\ant\src\main\org\apache\tools\ant\taskdefs\SendEmail.java", "Java", 7, 0, 0, 0, 35, 4, 46
"c:\Users\zipasink\OneDrive\PhD\research\research-workspace\interactive-auto-mapping-tool\test-systems\ant\src\main\org\apache\tools\ant\taskdefs\Sequential.java", "Java", 18, 0, 0, 0, 42, 6, 66
"c:\Users\zipasink\OneDrive\PhD\research\research-workspace\interactive-auto-mapping-tool\test-systems\ant\src\main\org\apache\tools\ant\taskdefs\SignJar.java", "Java", 203, 0, 0, 0, 230, 68, 501
"c:\Users\zipasink\OneDrive\PhD\research\research-workspace\interactive-auto-mapping-tool\test-systems\ant\src\main\org\apache\tools\ant\taskdefs\Sleep.java", "Java", 62, 0, 0, 0, 99, 31, 192
"c:\Users\zipasink\OneDrive\PhD\research\research-workspace\interactive-auto-mapping-tool\test-systems\ant\src\main\org\apache\tools\ant\taskdefs\StreamPumper.java", "Java", 86, 0, 0, 0, 76, 17, 179
"c:\Users\zipasink\OneDrive\PhD\research\research-workspace\interactive-auto-mapping-tool\test-systems\ant\src\main\org\apache\tools\ant\taskdefs\SubAnt.java", "Java", 304, 0, 0, 0, 250, 54, 608
"c:\Users\zipasink\OneDrive\PhD\research\research-workspace\interactive-auto-mapping-tool\test-systems\ant\src\main\org\apache\tools\ant\taskdefs\Sync.java", "Java", 218, 0, 0, 0, 199, 56, 473
"c:\Users\zipasink\OneDrive\PhD\research\research-workspace\interactive-auto-mapping-tool\test-systems\ant\src\main\org\apache\tools\ant\taskdefs\Tar.java", "Java", 523, 0, 0, 0, 344, 86, 953
"c:\Users\zipasink\OneDrive\PhD\research\research-workspace\interactive-auto-mapping-tool\test-systems\ant\src\main\org\apache\tools\ant\taskdefs\TaskOutputStream.java", "Java", 34, 0, 0, 0, 47, 15, 96
"c:\Users\zipasink\OneDrive\PhD\research\research-workspace\interactive-auto-mapping-tool\test-systems\ant\src\main\org\apache\tools\ant\taskdefs\Taskdef.java", "Java", 9, 0, 0, 0, 38, 6, 53
"c:\Users\zipasink\OneDrive\PhD\research\research-workspace\interactive-auto-mapping-tool\test-systems\ant\src\main\org\apache\tools\ant\taskdefs\TempFile.java", "Java", 42, 0, 0, 0, 82, 21, 145
"c:\Users\zipasink\OneDrive\PhD\research\research-workspace\interactive-auto-mapping-tool\test-systems\ant\src\main\org\apache\tools\ant\taskdefs\Touch.java", "Java", 214, 0, 0, 0, 125, 31, 370
"c:\Users\zipasink\OneDrive\PhD\research\research-workspace\interactive-auto-mapping-tool\test-systems\ant\src\main\org\apache\tools\ant\taskdefs\Transform.java", "Java", 3, 0, 0, 0, 25, 3, 31
"c:\Users\zipasink\OneDrive\PhD\research\research-workspace\interactive-auto-mapping-tool\test-systems\ant\src\main\org\apache\tools\ant\taskdefs\Tstamp.java", "Java", 180, 0, 0, 0, 128, 33, 341
"c:\Users\zipasink\OneDrive\PhD\research\research-workspace\interactive-auto-mapping-tool\test-systems\ant\src\main\org\apache\tools\ant\taskdefs\Typedef.java", "Java", 3, 0, 0, 0, 39, 5, 47
"c:\Users\zipasink\OneDrive\PhD\research\research-workspace\interactive-auto-mapping-tool\test-systems\ant\src\main\org\apache\tools\ant\taskdefs\Unpack.java", "Java", 89, 0, 0, 0, 78, 21, 188
"c:\Users\zipasink\OneDrive\PhD\research\research-workspace\interactive-auto-mapping-tool\test-systems\ant\src\main\org\apache\tools\ant\taskdefs\Untar.java", "Java", 104, 0, 0, 0, 102, 18, 224
"c:\Users\zipasink\OneDrive\PhD\research\research-workspace\interactive-auto-mapping-tool\test-systems\ant\src\main\org\apache\tools\ant\taskdefs\UpToDate.java", "Java", 149, 0, 0, 0, 95, 29, 273
"c:\Users\zipasink\OneDrive\PhD\research\research-workspace\interactive-auto-mapping-tool\test-systems\ant\src\main\org\apache\tools\ant\taskdefs\VerifyJar.java", "Java", 113, 0, 0, 0, 61, 35, 209
"c:\Users\zipasink\OneDrive\PhD\research\research-workspace\interactive-auto-mapping-tool\test-systems\ant\src\main\org\apache\tools\ant\taskdefs\WaitFor.java", "Java", 104, 0, 0, 0, 104, 22, 230
"c:\Users\zipasink\OneDrive\PhD\research\research-workspace\interactive-auto-mapping-tool\test-systems\ant\src\main\org\apache\tools\ant\taskdefs\War.java", "Java", 95, 0, 0, 0, 113, 22, 230
"c:\Users\zipasink\OneDrive\PhD\research\research-workspace\interactive-auto-mapping-tool\test-systems\ant\src\main\org\apache\tools\ant\taskdefs\WhichResource.java", "Java", 88, 0, 0, 0, 72, 23, 183
"c:\Users\zipasink\OneDrive\PhD\research\research-workspace\interactive-auto-mapping-tool\test-systems\ant\src\main\org\apache\tools\ant\taskdefs\XSLTLiaison.java", "Java", 8, 0, 0, 0, 52, 9, 69
"c:\Users\zipasink\OneDrive\PhD\research\research-workspace\interactive-auto-mapping-tool\test-systems\ant\src\main\org\apache\tools\ant\taskdefs\XSLTLiaison2.java", "Java", 4, 0, 0, 0, 27, 3, 34
"c:\Users\zipasink\OneDrive\PhD\research\research-workspace\interactive-auto-mapping-tool\test-systems\ant\src\main\org\apache\tools\ant\taskdefs\XSLTLiaison3.java", "Java", 5, 0, 0, 0, 28, 3, 36
"c:\Users\zipasink\OneDrive\PhD\research\research-workspace\interactive-auto-mapping-tool\test-systems\ant\src\main\org\apache\tools\ant\taskdefs\XSLTLogger.java", "Java", 4, 0, 0, 0, 25, 3, 32
"c:\Users\zipasink\OneDrive\PhD\research\research-workspace\interactive-auto-mapping-tool\test-systems\ant\src\main\org\apache\tools\ant\taskdefs\XSLTLoggerAware.java", "Java", 4, 0, 0, 0, 25, 3, 32
"c:\Users\zipasink\OneDrive\PhD\research\research-workspace\interactive-auto-mapping-tool\test-systems\ant\src\main\org\apache\tools\ant\taskdefs\XSLTProcess.java", "Java", 579, 0, 0, 0, 510, 135, 1224
"c:\Users\zipasink\OneDrive\PhD\research\research-workspace\interactive-auto-mapping-tool\test-systems\ant\src\main\org\apache\tools\ant\taskdefs\XmlProperty.java", "Java", 365, 0, 0, 0, 351, 76, 792
"c:\Users\zipasink\OneDrive\PhD\research\research-workspace\interactive-auto-mapping-tool\test-systems\ant\src\main\org\apache\tools\ant\taskdefs\Zip.java", "Java", 996, 0, 0, 0, 559, 162, 1717
"c:\Users\zipasink\OneDrive\PhD\research\research-workspace\interactive-auto-mapping-tool\test-systems\ant\src\main\org\apache\tools\ant\taskdefs\compilers\AptCompilerAdapter.java", "Java", 75, 0, 0, 0, 97, 18, 190
"c:\Users\zipasink\OneDrive\PhD\research\research-workspace\interactive-auto-mapping-tool\test-systems\ant\src\main\org\apache\tools\ant\taskdefs\compilers\AptExternalCompilerAdapter.java", "Java", 23, 0, 0, 0, 36, 13, 72
"c:\Users\zipasink\OneDrive\PhD\research\research-workspace\interactive-auto-mapping-tool\test-systems\ant\src\main\org\apache\tools\ant\taskdefs\compilers\CompilerAdapter.java", "Java", 7, 0, 0, 0, 39, 7, 53
"c:\Users\zipasink\OneDrive\PhD\research\research-workspace\interactive-auto-mapping-tool\test-systems\ant\src\main\org\apache\tools\ant\taskdefs\compilers\CompilerAdapterFactory.java", "Java", 101, 0, 0, 0, 65, 11, 177
"c:\Users\zipasink\OneDrive\PhD\research\research-workspace\interactive-auto-mapping-tool\test-systems\ant\src\main\org\apache\tools\ant\taskdefs\compilers\DefaultCompilerAdapter.java", "Java", 395, 0, 0, 0, 191, 63, 649
"c:\Users\zipasink\OneDrive\PhD\research\research-workspace\interactive-auto-mapping-tool\test-systems\ant\src\main\org\apache\tools\ant\taskdefs\compilers\Gcj.java", "Java", 76, 0, 0, 0, 48, 24, 148
"c:\Users\zipasink\OneDrive\PhD\research\research-workspace\interactive-auto-mapping-tool\test-systems\ant\src\main\org\apache\tools\ant\taskdefs\compilers\Javac12.java", "Java", 51, 0, 0, 0, 32, 7, 90
"c:\Users\zipasink\OneDrive\PhD\research\research-workspace\interactive-auto-mapping-tool\test-systems\ant\src\main\org\apache\tools\ant\taskdefs\compilers\Javac13.java", "Java", 29, 0, 0, 0, 33, 8, 70
"c:\Users\zipasink\OneDrive\PhD\research\research-workspace\interactive-auto-mapping-tool\test-systems\ant\src\main\org\apache\tools\ant\taskdefs\compilers\JavacExternal.java", "Java", 46, 0, 0, 0, 36, 11, 93
"c:\Users\zipasink\OneDrive\PhD\research\research-workspace\interactive-auto-mapping-tool\test-systems\ant\src\main\org\apache\tools\ant\taskdefs\compilers\Jikes.java", "Java", 123, 0, 0, 0, 74, 30, 227
"c:\Users\zipasink\OneDrive\PhD\research\research-workspace\interactive-auto-mapping-tool\test-systems\ant\src\main\org\apache\tools\ant\taskdefs\compilers\Jvc.java", "Java", 57, 0, 0, 0, 39, 20, 116
"c:\Users\zipasink\OneDrive\PhD\research\research-workspace\interactive-auto-mapping-tool\test-systems\ant\src\main\org\apache\tools\ant\taskdefs\compilers\Kjc.java", "Java", 59, 0, 0, 0, 38, 23, 120
"c:\Users\zipasink\OneDrive\PhD\research\research-workspace\interactive-auto-mapping-tool\test-systems\ant\src\main\org\apache\tools\ant\taskdefs\compilers\Sj.java", "Java", 18, 0, 0, 0, 34, 10, 62
"c:\Users\zipasink\OneDrive\PhD\research\research-workspace\interactive-auto-mapping-tool\test-systems\ant\src\main\org\apache\tools\ant\taskdefs\condition\And.java", "Java", 15, 0, 0, 0, 29, 6, 50
"c:\Users\zipasink\OneDrive\PhD\research\research-workspace\interactive-auto-mapping-tool\test-systems\ant\src\main\org\apache\tools\ant\taskdefs\condition\AntVersion.java", "Java", 68, 0, 0, 0, 47, 12, 127
"c:\Users\zipasink\OneDrive\PhD\research\research-workspace\interactive-auto-mapping-tool\test-systems\ant\src\main\org\apache\tools\ant\taskdefs\condition\Condition.java", "Java", 5, 0, 0, 0, 26, 5, 36
"c:\Users\zipasink\OneDrive\PhD\research\research-workspace\interactive-auto-mapping-tool\test-systems\ant\src\main\org\apache\tools\ant\taskdefs\condition\ConditionBase.java", "Java", 100, 0, 0, 0, 174, 33, 307
"c:\Users\zipasink\OneDrive\PhD\research\research-workspace\interactive-auto-mapping-tool\test-systems\ant\src\main\org\apache\tools\ant\taskdefs\condition\Contains.java", "Java", 24, 0, 0, 0, 43, 10, 77
"c:\Users\zipasink\OneDrive\PhD\research\research-workspace\interactive-auto-mapping-tool\test-systems\ant\src\main\org\apache\tools\ant\taskdefs\condition\Equals.java", "Java", 30, 0, 0, 0, 47, 12, 89
"c:\Users\zipasink\OneDrive\PhD\research\research-workspace\interactive-auto-mapping-tool\test-systems\ant\src\main\org\apache\tools\ant\taskdefs\condition\FilesMatch.java", "Java", 34, 0, 0, 0, 51, 16, 101
"c:\Users\zipasink\OneDrive\PhD\research\research-workspace\interactive-auto-mapping-tool\test-systems\ant\src\main\org\apache\tools\ant\taskdefs\condition\HasFreeSpace.java", "Java", 45, 0, 0, 0, 32, 12, 89
"c:\Users\zipasink\OneDrive\PhD\research\research-workspace\interactive-auto-mapping-tool\test-systems\ant\src\main\org\apache\tools\ant\taskdefs\condition\HasMethod.java", "Java", 105, 0, 0, 0, 61, 18, 184
"c:\Users\zipasink\OneDrive\PhD\research\research-workspace\interactive-auto-mapping-tool\test-systems\ant\src\main\org\apache\tools\ant\taskdefs\condition\Http.java", "Java", 46, 0, 0, 0, 36, 8, 90
"c:\Users\zipasink\OneDrive\PhD\research\research-workspace\interactive-auto-mapping-tool\test-systems\ant\src\main\org\apache\tools\ant\taskdefs\condition\IsFailure.java", "Java", 14, 0, 0, 0, 33, 8, 55
"c:\Users\zipasink\OneDrive\PhD\research\research-workspace\interactive-auto-mapping-tool\test-systems\ant\src\main\org\apache\tools\ant\taskdefs\condition\IsFalse.java", "Java", 15, 0, 0, 0, 33, 8, 56
"c:\Users\zipasink\OneDrive\PhD\research\research-workspace\interactive-auto-mapping-tool\test-systems\ant\src\main\org\apache\tools\ant\taskdefs\condition\IsFileSelected.java", "Java", 36, 0, 0, 0, 36, 9, 81
"c:\Users\zipasink\OneDrive\PhD\research\research-workspace\interactive-auto-mapping-tool\test-systems\ant\src\main\org\apache\tools\ant\taskdefs\condition\IsReachable.java", "Java", 98, 0, 0, 0, 95, 15, 208
"c:\Users\zipasink\OneDrive\PhD\research\research-workspace\interactive-auto-mapping-tool\test-systems\ant\src\main\org\apache\tools\ant\taskdefs\condition\IsReference.java", "Java", 37, 0, 0, 0, 40, 13, 90
"c:\Users\zipasink\OneDrive\PhD\research\research-workspace\interactive-auto-mapping-tool\test-systems\ant\src\main\org\apache\tools\ant\taskdefs\condition\IsSet.java", "Java", 16, 0, 0, 0, 31, 8, 55
"c:\Users\zipasink\OneDrive\PhD\research\research-workspace\interactive-auto-mapping-tool\test-systems\ant\src\main\org\apache\tools\ant\taskdefs\condition\IsSigned.java", "Java", 75, 0, 0, 0, 47, 13, 135
"c:\Users\zipasink\OneDrive\PhD\research\research-workspace\interactive-auto-mapping-tool\test-systems\ant\src\main\org\apache\tools\ant\taskdefs\condition\IsTrue.java", "Java", 15, 0, 0, 0, 33, 8, 56
"c:\Users\zipasink\OneDrive\PhD\research\research-workspace\interactive-auto-mapping-tool\test-systems\ant\src\main\org\apache\tools\ant\taskdefs\condition\Matches.java", "Java", 61, 0, 0, 0, 57, 11, 129
"c:\Users\zipasink\OneDrive\PhD\research\research-workspace\interactive-auto-mapping-tool\test-systems\ant\src\main\org\apache\tools\ant\taskdefs\condition\Not.java", "Java", 14, 0, 0, 0, 31, 6, 51
"c:\Users\zipasink\OneDrive\PhD\research\research-workspace\interactive-auto-mapping-tool\test-systems\ant\src\main\org\apache\tools\ant\taskdefs\condition\Or.java", "Java", 15, 0, 0, 0, 29, 6, 50
"c:\Users\zipasink\OneDrive\PhD\research\research-workspace\interactive-auto-mapping-tool\test-systems\ant\src\main\org\apache\tools\ant\taskdefs\condition\Os.java", "Java", 127, 0, 0, 0, 164, 22, 313
"c:\Users\zipasink\OneDrive\PhD\research\research-workspace\interactive-auto-mapping-tool\test-systems\ant\src\main\org\apache\tools\ant\taskdefs\condition\ParserSupports.java", "Java", 83, 0, 0, 0, 56, 13, 152
"c:\Users\zipasink\OneDrive\PhD\research\research-workspace\interactive-auto-mapping-tool\test-systems\ant\src\main\org\apache\tools\ant\taskdefs\condition\ResourcesMatch.java", "Java", 46, 0, 0, 0, 39, 9, 94
"c:\Users\zipasink\OneDrive\PhD\research\research-workspace\interactive-auto-mapping-tool\test-systems\ant\src\main\org\apache\tools\ant\taskdefs\condition\Socket.java", "Java", 40, 0, 0, 0, 39, 8, 87
"c:\Users\zipasink\OneDrive\PhD\research\research-workspace\interactive-auto-mapping-tool\test-systems\ant\src\main\org\apache\tools\ant\taskdefs\condition\TypeFound.java", "Java", 38, 0, 0, 0, 42, 11, 91
"c:\Users\zipasink\OneDrive\PhD\research\research-workspace\interactive-auto-mapping-tool\test-systems\ant\src\main\org\apache\tools\ant\taskdefs\condition\Xor.java", "Java", 14, 0, 0, 0, 29, 6, 49
"c:\Users\zipasink\OneDrive\PhD\research\research-workspace\interactive-auto-mapping-tool\test-systems\ant\src\main\org\apache\tools\ant\taskdefs\cvslib\CVSEntry.java", "Java", 39, 0, 0, 0, 62, 12, 113
"c:\Users\zipasink\OneDrive\PhD\research\research-workspace\interactive-auto-mapping-tool\test-systems\ant\src\main\org\apache\tools\ant\taskdefs\cvslib\ChangeLogParser.java", "Java", 146, 0, 0, 0, 88, 29, 263
"c:\Users\zipasink\OneDrive\PhD\research\research-workspace\interactive-auto-mapping-tool\test-systems\ant\src\main\org\apache\tools\ant\taskdefs\cvslib\ChangeLogTask.java", "Java", 196, 0, 0, 0, 158, 66, 420
"c:\Users\zipasink\OneDrive\PhD\research\research-workspace\interactive-auto-mapping-tool\test-systems\ant\src\main\org\apache\tools\ant\taskdefs\cvslib\ChangeLogWriter.java", "Java", 64, 0, 0, 0, 37, 15, 116
"c:\Users\zipasink\OneDrive\PhD\research\research-workspace\interactive-auto-mapping-tool\test-systems\ant\src\main\org\apache\tools\ant\taskdefs\cvslib\CvsTagDiff.java", "Java", 238, 0, 0, 0, 175, 45, 458
"c:\Users\zipasink\OneDrive\PhD\research\research-workspace\interactive-auto-mapping-tool\test-systems\ant\src\main\org\apache\tools\ant\taskdefs\cvslib\CvsTagEntry.java", "Java", 44, 0, 0, 0, 54, 12, 110
"c:\Users\zipasink\OneDrive\PhD\research\research-workspace\interactive-auto-mapping-tool\test-systems\ant\src\main\org\apache\tools\ant\taskdefs\cvslib\CvsUser.java", "Java", 29, 0, 0, 0, 49, 16, 94
"c:\Users\zipasink\OneDrive\PhD\research\research-workspace\interactive-auto-mapping-tool\test-systems\ant\src\main\org\apache\tools\ant\taskdefs\cvslib\CvsVersion.java", "Java", 90, 0, 0, 0, 57, 7, 154
"c:\Users\zipasink\OneDrive\PhD\research\research-workspace\interactive-auto-mapping-tool\test-systems\ant\src\main\org\apache\tools\ant\taskdefs\cvslib\RCSFile.java", "Java", 27, 0, 0, 0, 33, 10, 70
"c:\Users\zipasink\OneDrive\PhD\research\research-workspace\interactive-auto-mapping-tool\test-systems\ant\src\main\org\apache\tools\ant\taskdefs\cvslib\RedirectingOutputStream.java", "Java", 11, 0, 0, 0, 30, 6, 47
"c:\Users\zipasink\OneDrive\PhD\research\research-workspace\interactive-auto-mapping-tool\test-systems\ant\src\main\org\apache\tools\ant\taskdefs\cvslib\RedirectingStreamHandler.java", "Java", 30, 0, 0, 0, 22, 9, 61
"c:\Users\zipasink\OneDrive\PhD\research\research-workspace\interactive-auto-mapping-tool\test-systems\ant\src\main\org\apache\tools\ant\taskdefs\defaults.properties", "Properties", 0, 207, 0, 0, 3, 4, 214
"c:\Users\zipasink\OneDrive\PhD\research\research-workspace\interactive-auto-mapping-tool\test-systems\ant\src\main\org\apache\tools\ant\taskdefs\email\EmailAddress.java", "Java", 102, 0, 0, 0, 72, 24, 198
"c:\Users\zipasink\OneDrive\PhD\research\research-workspace\interactive-auto-mapping-tool\test-systems\ant\src\main\org\apache\tools\ant\taskdefs\email\EmailTask.java", "Java", 298, 0, 0, 0, 230, 53, 581
"c:\Users\zipasink\OneDrive\PhD\research\research-workspace\interactive-auto-mapping-tool\test-systems\ant\src\main\org\apache\tools\ant\taskdefs\email\Header.java", "Java", 17, 0, 0, 0, 37, 8, 62
"c:\Users\zipasink\OneDrive\PhD\research\research-workspace\interactive-auto-mapping-tool\test-systems\ant\src\main\org\apache\tools\ant\taskdefs\email\Mailer.java", "Java", 76, 0, 0, 0, 123, 22, 221
"c:\Users\zipasink\OneDrive\PhD\research\research-workspace\interactive-auto-mapping-tool\test-systems\ant\src\main\org\apache\tools\ant\taskdefs\email\Message.java", "Java", 67, 0, 0, 0, 79, 24, 170
"c:\Users\zipasink\OneDrive\PhD\research\research-workspace\interactive-auto-mapping-tool\test-systems\ant\src\main\org\apache\tools\ant\taskdefs\email\MimeMailer.java", "Java", 201, 0, 0, 0, 49, 37, 287
"c:\Users\zipasink\OneDrive\PhD\research\research-workspace\interactive-auto-mapping-tool\test-systems\ant\src\main\org\apache\tools\ant\taskdefs\email\PlainMailer.java", "Java", 88, 0, 0, 0, 34, 16, 138
"c:\Users\zipasink\OneDrive\PhD\research\research-workspace\interactive-auto-mapping-tool\test-systems\ant\src\main\org\apache\tools\ant\taskdefs\email\UUMailer.java", "Java", 26, 0, 0, 0, 22, 8, 56
"c:\Users\zipasink\OneDrive\PhD\research\research-workspace\interactive-auto-mapping-tool\test-systems\ant\src\main\org\apache\tools\ant\taskdefs\optional\ANTLR.java", "Java", 247, 0, 0, 0, 145, 45, 437
"c:\Users\zipasink\OneDrive\PhD\research\research-workspace\interactive-auto-mapping-tool\test-systems\ant\src\main\org\apache\tools\ant\taskdefs\optional\Cab.java", "Java", 196, 0, 0, 0, 103, 53, 352
"c:\Users\zipasink\OneDrive\PhD\research\research-workspace\interactive-auto-mapping-tool\test-systems\ant\src\main\org\apache\tools\ant\taskdefs\optional\EchoProperties.java", "Java", 296, 0, 0, 0, 196, 48, 540
"c:\Users\zipasink\OneDrive\PhD\research\research-workspace\interactive-auto-mapping-tool\test-systems\ant\src\main\org\apache\tools\ant\taskdefs\optional\Javah.java", "Java", 210, 0, 0, 0, 206, 50, 466
"c:\Users\zipasink\OneDrive\PhD\research\research-workspace\interactive-auto-mapping-tool\test-systems\ant\src\main\org\apache\tools\ant\taskdefs\optional\Native2Ascii.java", "Java", 153, 0, 0, 0, 112, 36, 301
"c:\Users\zipasink\OneDrive\PhD\research\research-workspace\interactive-auto-mapping-tool\test-systems\ant\src\main\org\apache\tools\ant\taskdefs\optional\NetRexxC.java", "Java", 488, 0, 0, 0, 342, 133, 963
"c:\Users\zipasink\OneDrive\PhD\research\research-workspace\interactive-auto-mapping-tool\test-systems\ant\src\main\org\apache\tools\ant\taskdefs\optional\PropertyFile.java", "Java", 344, 0, 0, 0, 252, 71, 667
"c:\Users\zipasink\OneDrive\PhD\research\research-workspace\interactive-auto-mapping-tool\test-systems\ant\src\main\org\apache\tools\ant\taskdefs\optional\RenameExtensions.java", "Java", 63, 0, 0, 0, 63, 20, 146
"c:\Users\zipasink\OneDrive\PhD\research\research-workspace\interactive-auto-mapping-tool\test-systems\ant\src\main\org\apache\tools\ant\taskdefs\optional\ReplaceRegExp.java", "Java", 280, 0, 0, 0, 190, 78, 548
"c:\Users\zipasink\OneDrive\PhD\research\research-workspace\interactive-auto-mapping-tool\test-systems\ant\src\main\org\apache\tools\ant\taskdefs\optional\Rpm.java", "Java", 189, 0, 0, 0, 139, 40, 368
"c:\Users\zipasink\OneDrive\PhD\research\research-workspace\interactive-auto-mapping-tool\test-systems\ant\src\main\org\apache\tools\ant\taskdefs\optional\SchemaValidate.java", "Java", 262, 0, 0, 0, 202, 63, 527
"c:\Users\zipasink\OneDrive\PhD\research\research-workspace\interactive-auto-mapping-tool\test-systems\ant\src\main\org\apache\tools\ant\taskdefs\optional\Script.java", "Java", 42, 0, 0, 0, 77, 14, 133
"c:\Users\zipasink\OneDrive\PhD\research\research-workspace\interactive-auto-mapping-tool\test-systems\ant\src\main\org\apache\tools\ant\taskdefs\optional\StyleBook.java", "Java", 46, 0, 0, 0, 59, 19, 124
"c:\Users\zipasink\OneDrive\PhD\research\research-workspace\interactive-auto-mapping-tool\test-systems\ant\src\main\org\apache\tools\ant\taskdefs\optional\TraXLiaison.java", "Java", 318, 0, 0, 0, 193, 59, 570
"c:\Users\zipasink\OneDrive\PhD\research\research-workspace\interactive-auto-mapping-tool\test-systems\ant\src\main\org\apache\tools\ant\taskdefs\optional\XMLValidateTask.java", "Java", 381, 0, 0, 0, 293, 72, 746
"c:\Users\zipasink\OneDrive\PhD\research\research-workspace\interactive-auto-mapping-tool\test-systems\ant\src\main\org\apache\tools\ant\taskdefs\optional\ccm\CCMCheck.java", "Java", 93, 0, 0, 0, 76, 39, 208
"c:\Users\zipasink\OneDrive\PhD\research\research-workspace\interactive-auto-mapping-tool\test-systems\ant\src\main\org\apache\tools\ant\taskdefs\optional\ccm\CCMCheckin.java", "Java", 9, 0, 0, 0, 24, 7, 40
"c:\Users\zipasink\OneDrive\PhD\research\research-workspace\interactive-auto-mapping-tool\test-systems\ant\src\main\org\apache\tools\ant\taskdefs\optional\ccm\CCMCheckinDefault.java", "Java", 9, 0, 0, 0, 24, 6, 39
"c:\Users\zipasink\OneDrive\PhD\research\research-workspace\interactive-auto-mapping-tool\test-systems\ant\src\main\org\apache\tools\ant\taskdefs\optional\ccm\CCMCheckout.java", "Java", 7, 0, 0, 0, 24, 5, 36
"c:\Users\zipasink\OneDrive\PhD\research\research-workspace\interactive-auto-mapping-tool\test-systems\ant\src\main\org\apache\tools\ant\taskdefs\optional\ccm\CCMCreateTask.java", "Java", 143, 0, 0, 0, 135, 57, 335
"c:\Users\zipasink\OneDrive\PhD\research\research-workspace\interactive-auto-mapping-tool\test-systems\ant\src\main\org\apache\tools\ant\taskdefs\optional\ccm\CCMReconfigure.java", "Java", 58, 0, 0, 0, 68, 34, 160
"c:\Users\zipasink\OneDrive\PhD\research\research-workspace\interactive-auto-mapping-tool\test-systems\ant\src\main\org\apache\tools\ant\taskdefs\optional\ccm\Continuus.java", "Java", 50, 0, 0, 0, 74, 21, 145
"c:\Users\zipasink\OneDrive\PhD\research\research-workspace\interactive-auto-mapping-tool\test-systems\ant\src\main\org\apache\tools\ant\taskdefs\optional\clearcase\CCCheckin.java", "Java", 112, 0, 0, 0, 196, 36, 344
"c:\Users\zipasink\OneDrive\PhD\research\research-workspace\interactive-auto-mapping-tool\test-systems\ant\src\main\org\apache\tools\ant\taskdefs\optional\clearcase\CCCheckout.java", "Java", 175, 0, 0, 0, 293, 49, 517
"c:\Users\zipasink\OneDrive\PhD\research\research-workspace\interactive-auto-mapping-tool\test-systems\ant\src\main\org\apache\tools\ant\taskdefs\optional\clearcase\CCLock.java", "Java", 127, 0, 0, 0, 216, 36, 379
"c:\Users\zipasink\OneDrive\PhD\research\research-workspace\interactive-auto-mapping-tool\test-systems\ant\src\main\org\apache\tools\ant\taskdefs\optional\clearcase\CCMkattr.java", "Java", 151, 0, 0, 0, 233, 42, 426
"c:\Users\zipasink\OneDrive\PhD\research\research-workspace\interactive-auto-mapping-tool\test-systems\ant\src\main\org\apache\tools\ant\taskdefs\optional\clearcase\CCMkbl.java", "Java", 118, 0, 0, 0, 209, 39, 366
"c:\Users\zipasink\OneDrive\PhD\research\research-workspace\interactive-auto-mapping-tool\test-systems\ant\src\main\org\apache\tools\ant\taskdefs\optional\clearcase\CCMkdir.java", "Java", 79, 0, 0, 0, 138, 21, 238
"c:\Users\zipasink\OneDrive\PhD\research\research-workspace\interactive-auto-mapping-tool\test-systems\ant\src\main\org\apache\tools\ant\taskdefs\optional\clearcase\CCMkelem.java", "Java", 143, 0, 0, 0, 248, 34, 425
"c:\Users\zipasink\OneDrive\PhD\research\research-workspace\interactive-auto-mapping-tool\test-systems\ant\src\main\org\apache\tools\ant\taskdefs\optional\clearcase\CCMklabel.java", "Java", 137, 0, 0, 0, 224, 42, 403
"c:\Users\zipasink\OneDrive\PhD\research\research-workspace\interactive-auto-mapping-tool\test-systems\ant\src\main\org\apache\tools\ant\taskdefs\optional\clearcase\CCMklbtype.java", "Java", 145, 0, 0, 0, 251, 45, 441
"c:\Users\zipasink\OneDrive\PhD\research\research-workspace\interactive-auto-mapping-tool\test-systems\ant\src\main\org\apache\tools\ant\taskdefs\optional\clearcase\CCRmtype.java", "Java", 125, 0, 0, 0, 215, 34, 374
"c:\Users\zipasink\OneDrive\PhD\research\research-workspace\interactive-auto-mapping-tool\test-systems\ant\src\main\org\apache\tools\ant\taskdefs\optional\clearcase\CCUnCheckout.java", "Java", 44, 0, 0, 0, 80, 18, 142
"c:\Users\zipasink\OneDrive\PhD\research\research-workspace\interactive-auto-mapping-tool\test-systems\ant\src\main\org\apache\tools\ant\taskdefs\optional\clearcase\CCUnlock.java", "Java", 86, 0, 0, 0, 149, 26, 261
"c:\Users\zipasink\OneDrive\PhD\research\research-workspace\interactive-auto-mapping-tool\test-systems\ant\src\main\org\apache\tools\ant\taskdefs\optional\clearcase\CCUpdate.java", "Java", 109, 0, 0, 0, 192, 31, 332
"c:\Users\zipasink\OneDrive\PhD\research\research-workspace\interactive-auto-mapping-tool\test-systems\ant\src\main\org\apache\tools\ant\taskdefs\optional\clearcase\ClearCase.java", "Java", 87, 0, 0, 0, 133, 22, 242
"c:\Users\zipasink\OneDrive\PhD\research\research-workspace\interactive-auto-mapping-tool\test-systems\ant\src\main\org\apache\tools\ant\taskdefs\optional\depend\AntAnalyzer.java", "Java", 95, 0, 0, 0, 43, 14, 152
"c:\Users\zipasink\OneDrive\PhD\research\research-workspace\interactive-auto-mapping-tool\test-systems\ant\src\main\org\apache\tools\ant\taskdefs\optional\depend\ClassFile.java", "Java", 49, 0, 0, 0, 50, 21, 120
"c:\Users\zipasink\OneDrive\PhD\research\research-workspace\interactive-auto-mapping-tool\test-systems\ant\src\main\org\apache\tools\ant\taskdefs\optional\depend\ClassFileIterator.java", "Java", 4, 0, 0, 0, 26, 4, 34
"c:\Users\zipasink\OneDrive\PhD\research\research-workspace\interactive-auto-mapping-tool\test-systems\ant\src\main\org\apache\tools\ant\taskdefs\optional\depend\ClassFileUtils.java", "Java", 9, 0, 0, 0, 38, 5, 52
"c:\Users\zipasink\OneDrive\PhD\research\research-workspace\interactive-auto-mapping-tool\test-systems\ant\src\main\org\apache\tools\ant\taskdefs\optional\depend\Depend.java", "Java", 544, 0, 0, 0, 241, 96, 881
"c:\Users\zipasink\OneDrive\PhD\research\research-workspace\interactive-auto-mapping-tool\test-systems\ant\src\main\org\apache\tools\ant\taskdefs\optional\depend\DirectoryIterator.java", "Java", 61, 0, 0, 0, 76, 28, 165
"c:\Users\zipasink\OneDrive\PhD\research\research-workspace\interactive-auto-mapping-tool\test-systems\ant\src\main\org\apache\tools\ant\taskdefs\optional\depend\JarFileIterator.java", "Java", 37, 0, 0, 0, 35, 18, 90
"c:\Users\zipasink\OneDrive\PhD\research\research-workspace\interactive-auto-mapping-tool\test-systems\ant\src\main\org\apache\tools\ant\taskdefs\optional\depend\constantpool\ClassCPInfo.java", "Java", 24, 0, 0, 0, 57, 13, 94
"c:\Users\zipasink\OneDrive\PhD\research\research-workspace\interactive-auto-mapping-tool\test-systems\ant\src\main\org\apache\tools\ant\taskdefs\optional\depend\constantpool\ConstantCPInfo.java", "Java", 13, 0, 0, 0, 43, 8, 64
"c:\Users\zipasink\OneDrive\PhD\research\research-workspace\interactive-auto-mapping-tool\test-systems\ant\src\main\org\apache\tools\ant\taskdefs\optional\depend\constantpool\ConstantPool.java", "Java", 161, 0, 0, 0, 135, 62, 358
"c:\Users\zipasink\OneDrive\PhD\research\research-workspace\interactive-auto-mapping-tool\test-systems\ant\src\main\org\apache\tools\ant\taskdefs\optional\depend\constantpool\ConstantPoolEntry.java", "Java", 82, 0, 0, 0, 99, 41, 222
"c:\Users\zipasink\OneDrive\PhD\research\research-workspace\interactive-auto-mapping-tool\test-systems\ant\src\main\org\apache\tools\ant\taskdefs\optional\depend\constantpool\DoubleCPInfo.java", "Java", 14, 0, 0, 0, 38, 7, 59
"c:\Users\zipasink\OneDrive\PhD\research\research-workspace\interactive-auto-mapping-tool\test-systems\ant\src\main\org\apache\tools\ant\taskdefs\optional\depend\constantpool\FieldRefCPInfo.java", "Java", 49, 0, 0, 0, 62, 20, 131
"c:\Users\zipasink\OneDrive\PhD\research\research-workspace\interactive-auto-mapping-tool\test-systems\ant\src\main\org\apache\tools\ant\taskdefs\optional\depend\constantpool\FloatCPInfo.java", "Java", 14, 0, 0, 0, 35, 8, 57
"c:\Users\zipasink\OneDrive\PhD\research\research-workspace\interactive-auto-mapping-tool\test-systems\ant\src\main\org\apache\tools\ant\taskdefs\optional\depend\constantpool\IntegerCPInfo.java", "Java", 14, 0, 0, 0, 35, 8, 57
"c:\Users\zipasink\OneDrive\PhD\research\research-workspace\interactive-auto-mapping-tool\test-systems\ant\src\main\org\apache\tools\ant\taskdefs\optional\depend\constantpool\InterfaceMethodRefCPInfo.java", "Java", 50, 0, 0, 0, 68, 20, 138
"c:\Users\zipasink\OneDrive\PhD\research\research-workspace\interactive-auto-mapping-tool\test-systems\ant\src\main\org\apache\tools\ant\taskdefs\optional\depend\constantpool\LongCPInfo.java", "Java", 14, 0, 0, 0, 35, 8, 57
"c:\Users\zipasink\OneDrive\PhD\research\research-workspace\interactive-auto-mapping-tool\test-systems\ant\src\main\org\apache\tools\ant\taskdefs\optional\depend\constantpool\MethodRefCPInfo.java", "Java", 49, 0, 0, 0, 65, 20, 134
"c:\Users\zipasink\OneDrive\PhD\research\research-workspace\interactive-auto-mapping-tool\test-systems\ant\src\main\org\apache\tools\ant\taskdefs\optional\depend\constantpool\NameAndTypeCPInfo.java", "Java", 37, 0, 0, 0, 62, 14, 113
"c:\Users\zipasink\OneDrive\PhD\research\research-workspace\interactive-auto-mapping-tool\test-systems\ant\src\main\org\apache\tools\ant\taskdefs\optional\depend\constantpool\StringCPInfo.java", "Java", 21, 0, 0, 0, 44, 10, 75
"c:\Users\zipasink\OneDrive\PhD\research\research-workspace\interactive-auto-mapping-tool\test-systems\ant\src\main\org\apache\tools\ant\taskdefs\optional\depend\constantpool\Utf8CPInfo.java", "Java", 18, 0, 0, 0, 41, 9, 68
"c:\Users\zipasink\OneDrive\PhD\research\research-workspace\interactive-auto-mapping-tool\test-systems\ant\src\main\org\apache\tools\ant\taskdefs\optional\dotnet\CSharp.java", "Java", 112, 0, 0, 0, 228, 60, 400
"c:\Users\zipasink\OneDrive\PhD\research\research-workspace\interactive-auto-mapping-tool\test-systems\ant\src\main\org\apache\tools\ant\taskdefs\optional\dotnet\DotnetBaseMatchingTask.java", "Java", 84, 0, 0, 0, 89, 22, 195
"c:\Users\zipasink\OneDrive\PhD\research\research-workspace\interactive-auto-mapping-tool\test-systems\ant\src\main\org\apache\tools\ant\taskdefs\optional\dotnet\DotnetCompile.java", "Java", 387, 0, 0, 0, 459, 149, 995
"c:\Users\zipasink\OneDrive\PhD\research\research-workspace\interactive-auto-mapping-tool\test-systems\ant\src\main\org\apache\tools\ant\taskdefs\optional\dotnet\DotnetDefine.java", "Java", 40, 0, 0, 0, 52, 11, 103
"c:\Users\zipasink\OneDrive\PhD\research\research-workspace\interactive-auto-mapping-tool\test-systems\ant\src\main\org\apache\tools\ant\taskdefs\optional\dotnet\DotnetResource.java", "Java", 119, 0, 0, 0, 104, 26, 249
"c:\Users\zipasink\OneDrive\PhD\research\research-workspace\interactive-auto-mapping-tool\test-systems\ant\src\main\org\apache\tools\ant\taskdefs\optional\dotnet\Ilasm.java", "Java", 185, 0, 0, 0, 269, 87, 541
"c:\Users\zipasink\OneDrive\PhD\research\research-workspace\interactive-auto-mapping-tool\test-systems\ant\src\main\org\apache\tools\ant\taskdefs\optional\dotnet\Ildasm.java", "Java", 199, 0, 0, 0, 225, 51, 475
"c:\Users\zipasink\OneDrive\PhD\research\research-workspace\interactive-auto-mapping-tool\test-systems\ant\src\main\org\apache\tools\ant\taskdefs\optional\dotnet\ImportTypelib.java", "Java", 98, 0, 0, 0, 96, 24, 218
"c:\Users\zipasink\OneDrive\PhD\research\research-workspace\interactive-auto-mapping-tool\test-systems\ant\src\main\org\apache\tools\ant\taskdefs\optional\dotnet\JSharp.java", "Java", 43, 0, 0, 0, 82, 17, 142
"c:\Users\zipasink\OneDrive\PhD\research\research-workspace\interactive-auto-mapping-tool\test-systems\ant\src\main\org\apache\tools\ant\taskdefs\optional\dotnet\NetCommand.java", "Java", 181, 0, 0, 0, 172, 52, 405
"c:\Users\zipasink\OneDrive\PhD\research\research-workspace\interactive-auto-mapping-tool\test-systems\ant\src\main\org\apache\tools\ant\taskdefs\optional\dotnet\VisualBasicCompile.java", "Java", 124, 0, 0, 0, 195, 48, 367
"c:\Users\zipasink\OneDrive\PhD\research\research-workspace\interactive-auto-mapping-tool\test-systems\ant\src\main\org\apache\tools\ant\taskdefs\optional\dotnet\WsdlToDotnet.java", "Java", 253, 0, 0, 0, 274, 69, 596
"c:\Users\zipasink\OneDrive\PhD\research\research-workspace\interactive-auto-mapping-tool\test-systems\ant\src\main\org\apache\tools\ant\taskdefs\optional\ejb\BorlandDeploymentTool.java", "Java", 294, 0, 0, 0, 191, 73, 558
"c:\Users\zipasink\OneDrive\PhD\research\research-workspace\interactive-auto-mapping-tool\test-systems\ant\src\main\org\apache\tools\ant\taskdefs\optional\ejb\BorlandGenerateClient.java", "Java", 163, 0, 0, 0, 103, 47, 313
"c:\Users\zipasink\OneDrive\PhD\research\research-workspace\interactive-auto-mapping-tool\test-systems\ant\src\main\org\apache\tools\ant\taskdefs\optional\ejb\DDCreator.java", "Java", 52, 0, 0, 0, 67, 14, 133
"c:\Users\zipasink\OneDrive\PhD\research\research-workspace\interactive-auto-mapping-tool\test-systems\ant\src\main\org\apache\tools\ant\taskdefs\optional\ejb\DDCreatorHelper.java", "Java", 63, 0, 0, 0, 65, 18, 146
"c:\Users\zipasink\OneDrive\PhD\research\research-workspace\interactive-auto-mapping-tool\test-systems\ant\src\main\org\apache\tools\ant\taskdefs\optional\ejb\DescriptorHandler.java", "Java", 201, 0, 0, 0, 143, 46, 390
"c:\Users\zipasink\OneDrive\PhD\research\research-workspace\interactive-auto-mapping-tool\test-systems\ant\src\main\org\apache\tools\ant\taskdefs\optional\ejb\EJBDeploymentTool.java", "Java", 11, 0, 0, 0, 40, 10, 61
"c:\Users\zipasink\OneDrive\PhD\research\research-workspace\interactive-auto-mapping-tool\test-systems\ant\src\main\org\apache\tools\ant\taskdefs\optional\ejb\EjbJar.java", "Java", 233, 0, 0, 0, 320, 76, 629
"c:\Users\zipasink\OneDrive\PhD\research\research-workspace\interactive-auto-mapping-tool\test-systems\ant\src\main\org\apache\tools\ant\taskdefs\optional\ejb\Ejbc.java", "Java", 79, 0, 0, 0, 96, 23, 198
"c:\Users\zipasink\OneDrive\PhD\research\research-workspace\interactive-auto-mapping-tool\test-systems\ant\src\main\org\apache\tools\ant\taskdefs\optional\ejb\EjbcHelper.java", "Java", 141, 0, 0, 0, 89, 30, 260
"c:\Users\zipasink\OneDrive\PhD\research\research-workspace\interactive-auto-mapping-tool\test-systems\ant\src\main\org\apache\tools\ant\taskdefs\optional\ejb\GenericDeploymentTool.java", "Java", 496, 0, 0, 0, 328, 129, 953
"c:\Users\zipasink\OneDrive\PhD\research\research-workspace\interactive-auto-mapping-tool\test-systems\ant\src\main\org\apache\tools\ant\taskdefs\optional\ejb\IPlanetDeploymentTool.java", "Java", 152, 0, 0, 0, 192, 41, 385
"c:\Users\zipasink\OneDrive\PhD\research\research-workspace\interactive-auto-mapping-tool\test-systems\ant\src\main\org\apache\tools\ant\taskdefs\optional\ejb\IPlanetEjbc.java", "Java", 782, 0, 0, 0, 514, 198, 1494
"c:\Users\zipasink\OneDrive\PhD\research\research-workspace\interactive-auto-mapping-tool\test-systems\ant\src\main\org\apache\tools\ant\taskdefs\optional\ejb\IPlanetEjbcTask.java", "Java", 142, 0, 0, 0, 151, 27, 320
"c:\Users\zipasink\OneDrive\PhD\research\research-workspace\interactive-auto-mapping-tool\test-systems\ant\src\main\org\apache\tools\ant\taskdefs\optional\ejb\InnerClassFilenameFilter.java", "Java", 20, 0, 0, 0, 30, 5, 55
"c:\Users\zipasink\OneDrive\PhD\research\research-workspace\interactive-auto-mapping-tool\test-systems\ant\src\main\org\apache\tools\ant\taskdefs\optional\ejb\JbossDeploymentTool.java", "Java", 54, 0, 0, 0, 47, 10, 111
"c:\Users\zipasink\OneDrive\PhD\research\research-workspace\interactive-auto-mapping-tool\test-systems\ant\src\main\org\apache\tools\ant\taskdefs\optional\ejb\JonasDeploymentTool.java", "Java", 395, 0, 0, 0, 292, 137, 824
"c:\Users\zipasink\OneDrive\PhD\research\research-workspace\interactive-auto-mapping-tool\test-systems\ant\src\main\org\apache\tools\ant\taskdefs\optional\ejb\WLRun.java", "Java", 187, 0, 0, 0, 175, 60, 422
"c:\Users\zipasink\OneDrive\PhD\research\research-workspace\interactive-auto-mapping-tool\test-systems\ant\src\main\org\apache\tools\ant\taskdefs\optional\ejb\WLStop.java", "Java", 61, 0, 0, 0, 92, 23, 176
"c:\Users\zipasink\OneDrive\PhD\research\research-workspace\interactive-auto-mapping-tool\test-systems\ant\src\main\org\apache\tools\ant\taskdefs\optional\ejb\WeblogicDeploymentTool.java", "Java", 474, 0, 0, 0, 306, 148, 928
"c:\Users\zipasink\OneDrive\PhD\research\research-workspace\interactive-auto-mapping-tool\test-systems\ant\src\main\org\apache\tools\ant\taskdefs\optional\ejb\WeblogicTOPLinkDeploymentTool.java", "Java", 47, 0, 0, 0, 51, 15, 113
"c:\Users\zipasink\OneDrive\PhD\research\research-workspace\interactive-auto-mapping-tool\test-systems\ant\src\main\org\apache\tools\ant\taskdefs\optional\ejb\WebsphereDeploymentTool.java", "Java", 448, 0, 0, 0, 287, 157, 892
"c:\Users\zipasink\OneDrive\PhD\research\research-workspace\interactive-auto-mapping-tool\test-systems\ant\src\main\org\apache\tools\ant\taskdefs\optional\extension\Compatability.java", "Java", 10, 0, 0, 0, 44, 4, 58
"c:\Users\zipasink\OneDrive\PhD\research\research-workspace\interactive-auto-mapping-tool\test-systems\ant\src\main\org\apache\tools\ant\taskdefs\optional\extension\Compatibility.java", "Java", 10, 0, 0, 0, 44, 4, 58
"c:\Users\zipasink\OneDrive\PhD\research\research-workspace\interactive-auto-mapping-tool\test-systems\ant\src\main\org\apache\tools\ant\taskdefs\optional\extension\DeweyDecimal.java", "Java", 10, 0, 0, 0, 38, 5, 53
"c:\Users\zipasink\OneDrive\PhD\research\research-workspace\interactive-auto-mapping-tool\test-systems\ant\src\main\org\apache\tools\ant\taskdefs\optional\extension\Extension.java", "Java", 329, 0, 0, 0, 280, 81, 690
"c:\Users\zipasink\OneDrive\PhD\research\research-workspace\interactive-auto-mapping-tool\test-systems\ant\src\main\org\apache\tools\ant\taskdefs\optional\extension\ExtensionAdapter.java", "Java", 100, 0, 0, 0, 106, 22, 228
"c:\Users\zipasink\OneDrive\PhD\research\research-workspace\interactive-auto-mapping-tool\test-systems\ant\src\main\org\apache\tools\ant\taskdefs\optional\extension\ExtensionResolver.java", "Java", 8, 0, 0, 0, 32, 3, 43
"c:\Users\zipasink\OneDrive\PhD\research\research-workspace\interactive-auto-mapping-tool\test-systems\ant\src\main\org\apache\tools\ant\taskdefs\optional\extension\ExtensionSet.java", "Java", 49, 0, 0, 0, 66, 11, 126
"c:\Users\zipasink\OneDrive\PhD\research\research-workspace\interactive-auto-mapping-tool\test-systems\ant\src\main\org\apache\tools\ant\taskdefs\optional\extension\ExtensionUtil.java", "Java", 127, 0, 0, 0, 71, 18, 216
"c:\Users\zipasink\OneDrive\PhD\research\research-workspace\interactive-auto-mapping-tool\test-systems\ant\src\main\org\apache\tools\ant\taskdefs\optional\extension\ExtraAttribute.java", "Java", 27, 0, 0, 0, 49, 8, 84
"c:\Users\zipasink\OneDrive\PhD\research\research-workspace\interactive-auto-mapping-tool\test-systems\ant\src\main\org\apache\tools\ant\taskdefs\optional\extension\JarLibAvailableTask.java", "Java", 76, 0, 0, 0, 66, 15, 157
"c:\Users\zipasink\OneDrive\PhD\research\research-workspace\interactive-auto-mapping-tool\test-systems\ant\src\main\org\apache\tools\ant\taskdefs\optional\extension\JarLibDisplayTask.java", "Java", 52, 0, 0, 0, 58, 9, 119
"c:\Users\zipasink\OneDrive\PhD\research\research-workspace\interactive-auto-mapping-tool\test-systems\ant\src\main\org\apache\tools\ant\taskdefs\optional\extension\JarLibManifestTask.java", "Java", 144, 0, 0, 0, 140, 31, 315
"c:\Users\zipasink\OneDrive\PhD\research\research-workspace\interactive-auto-mapping-tool\test-systems\ant\src\main\org\apache\tools\ant\taskdefs\optional\extension\JarLibResolveTask.java", "Java", 142, 0, 0, 0, 114, 30, 286
"c:\Users\zipasink\OneDrive\PhD\research\research-workspace\interactive-auto-mapping-tool\test-systems\ant\src\main\org\apache\tools\ant\taskdefs\optional\extension\LibFileSet.java", "Java", 26, 0, 0, 0, 81, 11, 118
"c:\Users\zipasink\OneDrive\PhD\research\research-workspace\interactive-auto-mapping-tool\test-systems\ant\src\main\org\apache\tools\ant\taskdefs\optional\extension\LibraryDisplayer.java", "Java", 83, 0, 0, 0, 55, 12, 150
"c:\Users\zipasink\OneDrive\PhD\research\research-workspace\interactive-auto-mapping-tool\test-systems\ant\src\main\org\apache\tools\ant\taskdefs\optional\extension\Specification.java", "Java", 295, 0, 0, 0, 240, 70, 605
"c:\Users\zipasink\OneDrive\PhD\research\research-workspace\interactive-auto-mapping-tool\test-systems\ant\src\main\org\apache\tools\ant\taskdefs\optional\extension\resolvers\AntResolver.java", "Java", 55, 0, 0, 0, 47, 15, 117
"c:\Users\zipasink\OneDrive\PhD\research\research-workspace\interactive-auto-mapping-tool\test-systems\ant\src\main\org\apache\tools\ant\taskdefs\optional\extension\resolvers\LocationResolver.java", "Java", 23, 0, 0, 0, 36, 6, 65
"c:\Users\zipasink\OneDrive\PhD\research\research-workspace\interactive-auto-mapping-tool\test-systems\ant\src\main\org\apache\tools\ant\taskdefs\optional\extension\resolvers\URLResolver.java", "Java", 69, 0, 0, 0, 50, 14, 133
"c:\Users\zipasink\OneDrive\PhD\research\research-workspace\interactive-auto-mapping-tool\test-systems\ant\src\main\org\apache\tools\ant\taskdefs\optional\i18n\Translate.java", "Java", 329, 0, 0, 0, 235, 63, 627
"c:\Users\zipasink\OneDrive\PhD\research\research-workspace\interactive-auto-mapping-tool\test-systems\ant\src\main\org\apache\tools\ant\taskdefs\optional\image\Image.java", "Java", 165, 0, 0, 0, 112, 33, 310
"c:\Users\zipasink\OneDrive\PhD\research\research-workspace\interactive-auto-mapping-tool\test-systems\ant\src\main\org\apache\tools\ant\taskdefs\optional\j2ee\AbstractHotDeploymentTool.java", "Java", 59, 0, 0, 0, 111, 24, 194
"c:\Users\zipasink\OneDrive\PhD\research\research-workspace\interactive-auto-mapping-tool\test-systems\ant\src\main\org\apache\tools\ant\taskdefs\optional\j2ee\GenericHotDeploymentTool.java", "Java", 44, 0, 0, 0, 81, 16, 141
"c:\Users\zipasink\OneDrive\PhD\research\research-workspace\interactive-auto-mapping-tool\test-systems\ant\src\main\org\apache\tools\ant\taskdefs\optional\j2ee\HotDeploymentTool.java", "Java", 12, 0, 0, 0, 40, 10, 62
"c:\Users\zipasink\OneDrive\PhD\research\research-workspace\interactive-auto-mapping-tool\test-systems\ant\src\main\org\apache\tools\ant\taskdefs\optional\j2ee\JonasHotDeploymentTool.java", "Java", 105, 0, 0, 0, 109, 38, 252
"c:\Users\zipasink\OneDrive\PhD\research\research-workspace\interactive-auto-mapping-tool\test-systems\ant\src\main\org\apache\tools\ant\taskdefs\optional\j2ee\ServerDeploy.java", "Java", 43, 0, 0, 0, 91, 19, 153
"c:\Users\zipasink\OneDrive\PhD\research\research-workspace\interactive-auto-mapping-tool\test-systems\ant\src\main\org\apache\tools\ant\taskdefs\optional\j2ee\WebLogicHotDeploymentTool.java", "Java", 109, 0, 0, 0, 106, 32, 247
"c:\Users\zipasink\OneDrive\PhD\research\research-workspace\interactive-auto-mapping-tool\test-systems\ant\src\main\org\apache\tools\ant\taskdefs\optional\javacc\JJDoc.java", "Java", 124, 0, 0, 0, 54, 38, 216
"c:\Users\zipasink\OneDrive\PhD\research\research-workspace\interactive-auto-mapping-tool\test-systems\ant\src\main\org\apache\tools\ant\taskdefs\optional\javacc\JJTree.java", "Java", 221, 0, 0, 0, 117, 68, 406
"c:\Users\zipasink\OneDrive\PhD\research\research-workspace\interactive-auto-mapping-tool\test-systems\ant\src\main\org\apache\tools\ant\taskdefs\optional\javacc\JavaCC.java", "Java", 289, 0, 0, 0, 189, 79, 557
"c:\Users\zipasink\OneDrive\PhD\research\research-workspace\interactive-auto-mapping-tool\test-systems\ant\src\main\org\apache\tools\ant\taskdefs\optional\javah\JavahAdapter.java", "Java", 6, 0, 0, 0, 29, 4, 39
"c:\Users\zipasink\OneDrive\PhD\research\research-workspace\interactive-auto-mapping-tool\test-systems\ant\src\main\org\apache\tools\ant\taskdefs\optional\javah\JavahAdapterFactory.java", "Java", 31, 0, 0, 0, 50, 7, 88
"c:\Users\zipasink\OneDrive\PhD\research\research-workspace\interactive-auto-mapping-tool\test-systems\ant\src\main\org\apache\tools\ant\taskdefs\optional\javah\Kaffeh.java", "Java", 52, 0, 0, 0, 30, 13, 95
"c:\Users\zipasink\OneDrive\PhD\research\research-workspace\interactive-auto-mapping-tool\test-systems\ant\src\main\org\apache\tools\ant\taskdefs\optional\javah\SunJavah.java", "Java", 76, 0, 0, 0, 32, 16, 124
"c:\Users\zipasink\OneDrive\PhD\research\research-workspace\interactive-auto-mapping-tool\test-systems\ant\src\main\org\apache\tools\ant\taskdefs\optional\jdepend\JDependTask.java", "Java", 375, 0, 0, 0, 234, 71, 680
"c:\Users\zipasink\OneDrive\PhD\research\research-workspace\interactive-auto-mapping-tool\test-systems\ant\src\main\org\apache\tools\ant\taskdefs\optional\jlink\ClassNameReader.java", "Java", 72, 0, 0, 0, 47, 20, 139
"c:\Users\zipasink\OneDrive\PhD\research\research-workspace\interactive-auto-mapping-tool\test-systems\ant\src\main\org\apache\tools\ant\taskdefs\optional\jlink\JlinkTask.java", "Java", 87, 0, 0, 0, 76, 20, 183
"c:\Users\zipasink\OneDrive\PhD\research\research-workspace\interactive-auto-mapping-tool\test-systems\ant\src\main\org\apache\tools\ant\taskdefs\optional\jlink\jlink.java", "Java", 252, 0, 0, 0, 138, 72, 462
"c:\Users\zipasink\OneDrive\PhD\research\research-workspace\interactive-auto-mapping-tool\test-systems\ant\src\main\org\apache\tools\ant\taskdefs\optional\jsp\Jasper41Mangler.java", "Java", 42, 0, 0, 0, 40, 11, 93
"c:\Users\zipasink\OneDrive\PhD\research\research-workspace\interactive-auto-mapping-tool\test-systems\ant\src\main\org\apache\tools\ant\taskdefs\optional\jsp\JspC.java", "Java", 315, 0, 0, 0, 297, 81, 693
"c:\Users\zipasink\OneDrive\PhD\research\research-workspace\interactive-auto-mapping-tool\test-systems\ant\src\main\org\apache\tools\ant\taskdefs\optional\jsp\JspMangler.java", "Java", 6, 0, 0, 0, 35, 7, 48
"c:\Users\zipasink\OneDrive\PhD\research\research-workspace\interactive-auto-mapping-tool\test-systems\ant\src\main\org\apache\tools\ant\taskdefs\optional\jsp\JspNameMangler.java", "Java", 79, 0, 0, 0, 64, 17, 160
"c:\Users\zipasink\OneDrive\PhD\research\research-workspace\interactive-auto-mapping-tool\test-systems\ant\src\main\org\apache\tools\ant\taskdefs\optional\jsp\WLJspc.java", "Java", 153, 0, 0, 0, 133, 43, 329
"c:\Users\zipasink\OneDrive\PhD\research\research-workspace\interactive-auto-mapping-tool\test-systems\ant\src\main\org\apache\tools\ant\taskdefs\optional\jsp\compilers\DefaultJspCompilerAdapter.java", "Java", 62, 0, 0, 0, 68, 23, 153
"c:\Users\zipasink\OneDrive\PhD\research\research-workspace\interactive-auto-mapping-tool\test-systems\ant\src\main\org\apache\tools\ant\taskdefs\optional\jsp\compilers\JasperC.java", "Java", 107, 0, 0, 0, 55, 20, 182
"c:\Users\zipasink\OneDrive\PhD\research\research-workspace\interactive-auto-mapping-tool\test-systems\ant\src\main\org\apache\tools\ant\taskdefs\optional\jsp\compilers\JspCompilerAdapter.java", "Java", 10, 0, 0, 0, 46, 9, 65
"c:\Users\zipasink\OneDrive\PhD\research\research-workspace\interactive-auto-mapping-tool\test-systems\ant\src\main\org\apache\tools\ant\taskdefs\optional\jsp\compilers\JspCompilerAdapterFactory.java", "Java", 43, 0, 0, 0, 69, 10, 122
"c:\Users\zipasink\OneDrive\PhD\research\research-workspace\interactive-auto-mapping-tool\test-systems\ant\src\main\org\apache\tools\ant\taskdefs\optional\junit\AggregateTransformer.java", "Java", 180, 0, 0, 0, 127, 40, 347
"c:\Users\zipasink\OneDrive\PhD\research\research-workspace\interactive-auto-mapping-tool\test-systems\ant\src\main\org\apache\tools\ant\taskdefs\optional\junit\BaseTest.java", "Java", 69, 0, 0, 0, 99, 22, 190
"c:\Users\zipasink\OneDrive\PhD\research\research-workspace\interactive-auto-mapping-tool\test-systems\ant\src\main\org\apache\tools\ant\taskdefs\optional\junit\BatchTest.java", "Java", 86, 0, 0, 0, 97, 20, 203
"c:\Users\zipasink\OneDrive\PhD\research\research-workspace\interactive-auto-mapping-tool\test-systems\ant\src\main\org\apache\tools\ant\taskdefs\optional\junit\BriefJUnitResultFormatter.java", "Java", 112, 0, 0, 0, 107, 31, 250
"c:\Users\zipasink\OneDrive\PhD\research\research-workspace\interactive-auto-mapping-tool\test-systems\ant\src\main\org\apache\tools\ant\taskdefs\optional\junit\Constants.java", "Java", 15, 0, 0, 0, 20, 4, 39
"c:\Users\zipasink\OneDrive\PhD\research\research-workspace\interactive-auto-mapping-tool\test-systems\ant\src\main\org\apache\tools\ant\taskdefs\optional\junit\DOMUtil.java", "Java", 129, 0, 0, 0, 83, 14, 226
"c:\Users\zipasink\OneDrive\PhD\research\research-workspace\interactive-auto-mapping-tool\test-systems\ant\src\main\org\apache\tools\ant\taskdefs\optional\junit\Enumerations.java", "Java", 54, 0, 0, 0, 104, 20, 178
"c:\Users\zipasink\OneDrive\PhD\research\research-workspace\interactive-auto-mapping-tool\test-systems\ant\src\main\org\apache\tools\ant\taskdefs\optional\junit\FormatterElement.java", "Java", 133, 0, 0, 0, 125, 26, 284
"c:\Users\zipasink\OneDrive\PhD\research\research-workspace\interactive-auto-mapping-tool\test-systems\ant\src\main\org\apache\tools\ant\taskdefs\optional\junit\JUnitResultFormatter.java", "Java", 12, 0, 0, 0, 44, 8, 64
"c:\Users\zipasink\OneDrive\PhD\research\research-workspace\interactive-auto-mapping-tool\test-systems\ant\src\main\org\apache\tools\ant\taskdefs\optional\junit\JUnitTask.java", "Java", 956, 0, 0, 0, 699, 138, 1793
"c:\Users\zipasink\OneDrive\PhD\research\research-workspace\interactive-auto-mapping-tool\test-systems\ant\src\main\org\apache\tools\ant\taskdefs\optional\junit\JUnitTaskMirror.java", "Java", 35, 0, 0, 0, 128, 26, 189
"c:\Users\zipasink\OneDrive\PhD\research\research-workspace\interactive-auto-mapping-tool\test-systems\ant\src\main\org\apache\tools\ant\taskdefs\optional\junit\JUnitTaskMirrorImpl.java", "Java", 56, 0, 0, 0, 34, 17, 107
"c:\Users\zipasink\OneDrive\PhD\research\research-workspace\interactive-auto-mapping-tool\test-systems\ant\src\main\org\apache\tools\ant\taskdefs\optional\junit\JUnitTest.java", "Java", 97, 0, 0, 0, 117, 28, 242
"c:\Users\zipasink\OneDrive\PhD\research\research-workspace\interactive-auto-mapping-tool\test-systems\ant\src\main\org\apache\tools\ant\taskdefs\optional\junit\JUnitTestRunner.java", "Java", 642, 0, 0, 0, 291, 104, 1037
"c:\Users\zipasink\OneDrive\PhD\research\research-workspace\interactive-auto-mapping-tool\test-systems\ant\src\main\org\apache\tools\ant\taskdefs\optional\junit\JUnitVersionHelper.java", "Java", 65, 0, 0, 0, 47, 8, 120
"c:\Users\zipasink\OneDrive\PhD\research\research-workspace\interactive-auto-mapping-tool\test-systems\ant\src\main\org\apache\tools\ant\taskdefs\optional\junit\OutErrSummaryJUnitResultFormatter.java", "Java", 8, 0, 0, 0, 24, 5, 37
"c:\Users\zipasink\OneDrive\PhD\research\research-workspace\interactive-auto-mapping-tool\test-systems\ant\src\main\org\apache\tools\ant\taskdefs\optional\junit\PlainJUnitResultFormatter.java", "Java", 132, 0, 0, 0, 88, 29, 249
"c:\Users\zipasink\OneDrive\PhD\research\research-workspace\interactive-auto-mapping-tool\test-systems\ant\src\main\org\apache\tools\ant\taskdefs\optional\junit\SummaryJUnitResultFormatter.java", "Java", 88, 0, 0, 0, 73, 17, 178
"c:\Users\zipasink\OneDrive\PhD\research\research-workspace\interactive-auto-mapping-tool\test-systems\ant\src\main\org\apache\tools\ant\taskdefs\optional\junit\XMLConstants.java", "Java", 25, 0, 0, 0, 91, 23, 139
"c:\Users\zipasink\OneDrive\PhD\research\research-workspace\interactive-auto-mapping-tool\test-systems\ant\src\main\org\apache\tools\ant\taskdefs\optional\junit\XMLJUnitResultFormatter.java", "Java", 161, 0, 0, 0, 99, 32, 292
"c:\Users\zipasink\OneDrive\PhD\research\research-workspace\interactive-auto-mapping-tool\test-systems\ant\src\main\org\apache\tools\ant\taskdefs\optional\junit\XMLResultAggregator.java", "Java", 171, 0, 0, 0, 128, 30, 329
"c:\Users\zipasink\OneDrive\PhD\research\research-workspace\interactive-auto-mapping-tool\test-systems\ant\src\main\org\apache\tools\ant\taskdefs\optional\junit\Xalan2Executor.java", "Java", 57, 0, 0, 0, 31, 9, 97
"c:\Users\zipasink\OneDrive\PhD\research\research-workspace\interactive-auto-mapping-tool\test-systems\ant\src\main\org\apache\tools\ant\taskdefs\optional\junit\XalanExecutor.java", "Java", 66, 0, 0, 0, 58, 12, 136
"c:\Users\zipasink\OneDrive\PhD\research\research-workspace\interactive-auto-mapping-tool\test-systems\ant\src\main\org\apache\tools\ant\taskdefs\optional\native2ascii\DefaultNative2Ascii.java", "Java", 32, 0, 0, 0, 66, 8, 106
"c:\Users\zipasink\OneDrive\PhD\research\research-workspace\interactive-auto-mapping-tool\test-systems\ant\src\main\org\apache\tools\ant\taskdefs\optional\native2ascii\KaffeNative2Ascii.java", "Java", 42, 0, 0, 0, 37, 10, 89
"c:\Users\zipasink\OneDrive\PhD\research\research-workspace\interactive-auto-mapping-tool\test-systems\ant\src\main\org\apache\tools\ant\taskdefs\optional\native2ascii\Native2AsciiAdapter.java", "Java", 8, 0, 0, 0, 32, 3, 43
"c:\Users\zipasink\OneDrive\PhD\research\research-workspace\interactive-auto-mapping-tool\test-systems\ant\src\main\org\apache\tools\ant\taskdefs\optional\native2ascii\Native2AsciiAdapterFactory.java", "Java", 32, 0, 0, 0, 50, 7, 89
"c:\Users\zipasink\OneDrive\PhD\research\research-workspace\interactive-auto-mapping-tool\test-systems\ant\src\main\org\apache\tools\ant\taskdefs\optional\native2ascii\SunNative2Ascii.java", "Java", 36, 0, 0, 0, 29, 6, 71
"c:\Users\zipasink\OneDrive\PhD\research\research-workspace\interactive-auto-mapping-tool\test-systems\ant\src\main\org\apache\tools\ant\taskdefs\optional\net\FTP.java", "Java", 1546, 0, 0, 0, 802, 214, 2562
"c:\Users\zipasink\OneDrive\PhD\research\research-workspace\interactive-auto-mapping-tool\test-systems\ant\src\main\org\apache\tools\ant\taskdefs\optional\net\FTPConfigurator.java", "Java", 52, 0, 0, 0, 33, 7, 92
"c:\Users\zipasink\OneDrive\PhD\research\research-workspace\interactive-auto-mapping-tool\test-systems\ant\src\main\org\apache\tools\ant\taskdefs\optional\net\MimeMail.java", "Java", 11, 0, 0, 0, 30, 3, 44
"c:\Users\zipasink\OneDrive\PhD\research\research-workspace\interactive-auto-mapping-tool\test-systems\ant\src\main\org\apache\tools\ant\taskdefs\optional\net\RExecTask.java", "Java", 246, 0, 0, 0, 192, 34, 472
"c:\Users\zipasink\OneDrive\PhD\research\research-workspace\interactive-auto-mapping-tool\test-systems\ant\src\main\org\apache\tools\ant\taskdefs\optional\net\SetProxy.java", "Java", 120, 0, 0, 0, 129, 33, 282
"c:\Users\zipasink\OneDrive\PhD\research\research-workspace\interactive-auto-mapping-tool\test-systems\ant\src\main\org\apache\tools\ant\taskdefs\optional\net\TelnetTask.java", "Java", 185, 0, 0, 0, 171, 33, 389
"c:\Users\zipasink\OneDrive\PhD\research\research-workspace\interactive-auto-mapping-tool\test-systems\ant\src\main\org\apache\tools\ant\taskdefs\optional\perforce\FStatP4OutputHandler.java", "Java", 31, 0, 0, 0, 23, 7, 61
"c:\Users\zipasink\OneDrive\PhD\research\research-workspace\interactive-auto-mapping-tool\test-systems\ant\src\main\org\apache\tools\ant\taskdefs\optional\perforce\P4Add.java", "Java", 60, 0, 0, 0, 69, 14, 143
"c:\Users\zipasink\OneDrive\PhD\research\research-workspace\interactive-auto-mapping-tool\test-systems\ant\src\main\org\apache\tools\ant\taskdefs\optional\perforce\P4Base.java", "Java", 118, 0, 0, 0, 153, 34, 305
"c:\Users\zipasink\OneDrive\PhD\research\research-workspace\interactive-auto-mapping-tool\test-systems\ant\src\main\org\apache\tools\ant\taskdefs\optional\perforce\P4Change.java", "Java", 65, 0, 0, 0, 64, 19, 148
"c:\Users\zipasink\OneDrive\PhD\research\research-workspace\interactive-auto-mapping-tool\test-systems\ant\src\main\org\apache\tools\ant\taskdefs\optional\perforce\P4Counter.java", "Java", 55, 0, 0, 0, 81, 16, 152
"c:\Users\zipasink\OneDrive\PhD\research\research-workspace\interactive-auto-mapping-tool\test-systems\ant\src\main\org\apache\tools\ant\taskdefs\optional\perforce\P4Delete.java", "Java", 17, 0, 0, 0, 43, 6, 66
"c:\Users\zipasink\OneDrive\PhD\research\research-workspace\interactive-auto-mapping-tool\test-systems\ant\src\main\org\apache\tools\ant\taskdefs\optional\perforce\P4Edit.java", "Java", 17, 0, 0, 0, 48, 9, 74
"c:\Users\zipasink\OneDrive\PhD\research\research-workspace\interactive-auto-mapping-tool\test-systems\ant\src\main\org\apache\tools\ant\taskdefs\optional\perforce\P4Fstat.java", "Java", 106, 0, 0, 0, 71, 22, 199
"c:\Users\zipasink\OneDrive\PhD\research\research-workspace\interactive-auto-mapping-tool\test-systems\ant\src\main\org\apache\tools\ant\taskdefs\optional\perforce\P4Handler.java", "Java", 7, 0, 0, 0, 31, 6, 44
"c:\Users\zipasink\OneDrive\PhD\research\research-workspace\interactive-auto-mapping-tool\test-systems\ant\src\main\org\apache\tools\ant\taskdefs\optional\perforce\P4HandlerAdapter.java", "Java", 42, 0, 0, 0, 62, 10, 114
"c:\Users\zipasink\OneDrive\PhD\research\research-workspace\interactive-auto-mapping-tool\test-systems\ant\src\main\org\apache\tools\ant\taskdefs\optional\perforce\P4Have.java", "Java", 7, 0, 0, 0, 34, 6, 47
"c:\Users\zipasink\OneDrive\PhD\research\research-workspace\interactive-auto-mapping-tool\test-systems\ant\src\main\org\apache\tools\ant\taskdefs\optional\perforce\P4Integrate.java", "Java", 129, 0, 0, 0, 163, 27, 319
"c:\Users\zipasink\OneDrive\PhD\research\research-workspace\interactive-auto-mapping-tool\test-systems\ant\src\main\org\apache\tools\ant\taskdefs\optional\perforce\P4Label.java", "Java", 87, 0, 0, 0, 58, 32, 177
"c:\Users\zipasink\OneDrive\PhD\research\research-workspace\interactive-auto-mapping-tool\test-systems\ant\src\main\org\apache\tools\ant\taskdefs\optional\perforce\P4Labelsync.java", "Java", 55, 0, 0, 0, 79, 17, 151
"c:\Users\zipasink\OneDrive\PhD\research\research-workspace\interactive-auto-mapping-tool\test-systems\ant\src\main\org\apache\tools\ant\taskdefs\optional\perforce\P4OutputHandler.java", "Java", 5, 0, 0, 0, 26, 4, 35
"c:\Users\zipasink\OneDrive\PhD\research\research-workspace\interactive-auto-mapping-tool\test-systems\ant\src\main\org\apache\tools\ant\taskdefs\optional\perforce\P4OutputStream.java", "Java", 33, 0, 0, 0, 41, 12, 86
"c:\Users\zipasink\OneDrive\PhD\research\research-workspace\interactive-auto-mapping-tool\test-systems\ant\src\main\org\apache\tools\ant\taskdefs\optional\perforce\P4Reopen.java", "Java", 17, 0, 0, 0, 36, 8, 61
"c:\Users\zipasink\OneDrive\PhD\research\research-workspace\interactive-auto-mapping-tool\test-systems\ant\src\main\org\apache\tools\ant\taskdefs\optional\perforce\P4Resolve.java", "Java", 92, 0, 0, 0, 81, 15, 188
"c:\Users\zipasink\OneDrive\PhD\research\research-workspace\interactive-auto-mapping-tool\test-systems\ant\src\main\org\apache\tools\ant\taskdefs\optional\perforce\P4Revert.java", "Java", 25, 0, 0, 0, 48, 13, 86
"c:\Users\zipasink\OneDrive\PhD\research\research-workspace\interactive-auto-mapping-tool\test-systems\ant\src\main\org\apache\tools\ant\taskdefs\optional\perforce\P4Submit.java", "Java", 66, 0, 0, 0, 80, 9, 155
"c:\Users\zipasink\OneDrive\PhD\research\research-workspace\interactive-auto-mapping-tool\test-systems\ant\src\main\org\apache\tools\ant\taskdefs\optional\perforce\P4Sync.java", "Java", 29, 0, 0, 0, 61, 18, 108
"c:\Users\zipasink\OneDrive\PhD\research\research-workspace\interactive-auto-mapping-tool\test-systems\ant\src\main\org\apache\tools\ant\taskdefs\optional\perforce\SimpleP4OutputHandler.java", "Java", 30, 0, 0, 0, 57, 10, 97
"c:\Users\zipasink\OneDrive\PhD\research\research-workspace\interactive-auto-mapping-tool\test-systems\ant\src\main\org\apache\tools\ant\taskdefs\optional\perforce\package.html", "HTML", 0, 0, 17, 0, 16, 8, 41
"c:\Users\zipasink\OneDrive\PhD\research\research-workspace\interactive-auto-mapping-tool\test-systems\ant\src\main\org\apache\tools\ant\taskdefs\optional\pvcs\Pvcs.java", "Java", 369, 0, 0, 0, 246, 65, 680
"c:\Users\zipasink\OneDrive\PhD\research\research-workspace\interactive-auto-mapping-tool\test-systems\ant\src\main\org\apache\tools\ant\taskdefs\optional\pvcs\PvcsProject.java", "Java", 13, 0, 0, 0, 29, 8, 50
"c:\Users\zipasink\OneDrive\PhD\research\research-workspace\interactive-auto-mapping-tool\test-systems\ant\src\main\org\apache\tools\ant\taskdefs\optional\scm\AntStarTeamCheckOut.java", "Java", 369, 0, 0, 0, 542, 170, 1081
"c:\Users\zipasink\OneDrive\PhD\research\research-workspace\interactive-auto-mapping-tool\test-systems\ant\src\main\org\apache\tools\ant\taskdefs\optional\script\ScriptDef.java", "Java", 189, 0, 0, 0, 151, 47, 387
"c:\Users\zipasink\OneDrive\PhD\research\research-workspace\interactive-auto-mapping-tool\test-systems\ant\src\main\org\apache\tools\ant\taskdefs\optional\script\ScriptDefBase.java", "Java", 57, 0, 0, 0, 59, 16, 132
"c:\Users\zipasink\OneDrive\PhD\research\research-workspace\interactive-auto-mapping-tool\test-systems\ant\src\main\org\apache\tools\ant\taskdefs\optional\sos\SOS.java", "Java", 211, 0, 0, 0, 219, 47, 477
"c:\Users\zipasink\OneDrive\PhD\research\research-workspace\interactive-auto-mapping-tool\test-systems\ant\src\main\org\apache\tools\ant\taskdefs\optional\sos\SOSCheckin.java", "Java", 33, 0, 0, 0, 59, 10, 102
"c:\Users\zipasink\OneDrive\PhD\research\research-workspace\interactive-auto-mapping-tool\test-systems\ant\src\main\org\apache\tools\ant\taskdefs\optional\sos\SOSCheckout.java", "Java", 26, 0, 0, 0, 51, 9, 86
"c:\Users\zipasink\OneDrive\PhD\research\research-workspace\interactive-auto-mapping-tool\test-systems\ant\src\main\org\apache\tools\ant\taskdefs\optional\sos\SOSCmd.java", "Java", 29, 0, 0, 0, 49, 3, 81
"c:\Users\zipasink\OneDrive\PhD\research\research-workspace\interactive-auto-mapping-tool\test-systems\ant\src\main\org\apache\tools\ant\taskdefs\optional\sos\SOSGet.java", "Java", 40, 0, 0, 0, 66, 11, 117
"c:\Users\zipasink\OneDrive\PhD\research\research-workspace\interactive-auto-mapping-tool\test-systems\ant\src\main\org\apache\tools\ant\taskdefs\optional\sos\SOSLabel.java", "Java", 31, 0, 0, 0, 50, 11, 92
"c:\Users\zipasink\OneDrive\PhD\research\research-workspace\interactive-auto-mapping-tool\test-systems\ant\src\main\org\apache\tools\ant\taskdefs\optional\sos\package.html", "HTML", 0, 0, 13, 0, 16, 1, 30
"c:\Users\zipasink\OneDrive\PhD\research\research-workspace\interactive-auto-mapping-tool\test-systems\ant\src\main\org\apache\tools\ant\taskdefs\optional\sound\AntSoundPlayer.java", "Java", 110, 0, 0, 0, 99, 33, 242
"c:\Users\zipasink\OneDrive\PhD\research\research-workspace\interactive-auto-mapping-tool\test-systems\ant\src\main\org\apache\tools\ant\taskdefs\optional\sound\SoundTask.java", "Java", 85, 0, 0, 0, 84, 24, 193
"c:\Users\zipasink\OneDrive\PhD\research\research-workspace\interactive-auto-mapping-tool\test-systems\ant\src\main\org\apache\tools\ant\taskdefs\optional\splash\SplashScreen.java", "Java", 93, 0, 0, 0, 17, 25, 135
"c:\Users\zipasink\OneDrive\PhD\research\research-workspace\interactive-auto-mapping-tool\test-systems\ant\src\main\org\apache\tools\ant\taskdefs\optional\splash\SplashTask.java", "Java", 147, 0, 0, 0, 70, 31, 248
"c:\Users\zipasink\OneDrive\PhD\research\research-workspace\interactive-auto-mapping-tool\test-systems\ant\src\main\org\apache\tools\ant\taskdefs\optional\ssh\AbstractSshMessage.java", "Java", 141, 0, 0, 0, 94, 35, 270
"c:\Users\zipasink\OneDrive\PhD\research\research-workspace\interactive-auto-mapping-tool\test-systems\ant\src\main\org\apache\tools\ant\taskdefs\optional\ssh\Directory.java", "Java", 82, 0, 0, 0, 86, 26, 194
"c:\Users\zipasink\OneDrive\PhD\research\research-workspace\interactive-auto-mapping-tool\test-systems\ant\src\main\org\apache\tools\ant\taskdefs\optional\ssh\LogListener.java", "Java", 4, 0, 0, 0, 24, 3, 31
"c:\Users\zipasink\OneDrive\PhD\research\research-workspace\interactive-auto-mapping-tool\test-systems\ant\src\main\org\apache\tools\ant\taskdefs\optional\ssh\SSHBase.java", "Java", 85, 0, 0, 0, 111, 28, 224
"c:\Users\zipasink\OneDrive\PhD\research\research-workspace\interactive-auto-mapping-tool\test-systems\ant\src\main\org\apache\tools\ant\taskdefs\optional\ssh\SSHExec.java", "Java", 157, 0, 0, 0, 78, 27, 262
"c:\Users\zipasink\OneDrive\PhD\research\research-workspace\interactive-auto-mapping-tool\test-systems\ant\src\main\org\apache\tools\ant\taskdefs\optional\ssh\SSHUserInfo.java", "Java", 81, 0, 0, 0, 110, 26, 217
"c:\Users\zipasink\OneDrive\PhD\research\research-workspace\interactive-auto-mapping-tool\test-systems\ant\src\main\org\apache\tools\ant\taskdefs\optional\ssh\Scp.java", "Java", 273, 0, 0, 0, 100, 38, 411
"c:\Users\zipasink\OneDrive\PhD\research\research-workspace\interactive-auto-mapping-tool\test-systems\ant\src\main\org\apache\tools\ant\taskdefs\optional\ssh\ScpFromMessage.java", "Java", 163, 0, 0, 0, 61, 22, 246
"c:\Users\zipasink\OneDrive\PhD\research\research-workspace\interactive-auto-mapping-tool\test-systems\ant\src\main\org\apache\tools\ant\taskdefs\optional\ssh\ScpFromMessageBySftp.java", "Java", 114, 0, 0, 0, 42, 14, 170
"c:\Users\zipasink\OneDrive\PhD\research\research-workspace\interactive-auto-mapping-tool\test-systems\ant\src\main\org\apache\tools\ant\taskdefs\optional\ssh\ScpToMessage.java", "Java", 169, 0, 0, 0, 83, 36, 288
"c:\Users\zipasink\OneDrive\PhD\research\research-workspace\interactive-auto-mapping-tool\test-systems\ant\src\main\org\apache\tools\ant\taskdefs\optional\ssh\ScpToMessageBySftp.java", "Java", 147, 0, 0, 0, 70, 27, 244
"c:\Users\zipasink\OneDrive\PhD\research\research-workspace\interactive-auto-mapping-tool\test-systems\ant\src\main\org\apache\tools\ant\taskdefs\optional\starteam\StarTeamCheckin.java", "Java", 174, 0, 0, 0, 139, 49, 362
"c:\Users\zipasink\OneDrive\PhD\research\research-workspace\interactive-auto-mapping-tool\test-systems\ant\src\main\org\apache\tools\ant\taskdefs\optional\starteam\StarTeamCheckout.java", "Java", 336, 0, 0, 0, 229, 79, 644
"c:\Users\zipasink\OneDrive\PhD\research\research-workspace\interactive-auto-mapping-tool\test-systems\ant\src\main\org\apache\tools\ant\taskdefs\optional\starteam\StarTeamLabel.java", "Java", 69, 0, 0, 0, 102, 26, 197
"c:\Users\zipasink\OneDrive\PhD\research\research-workspace\interactive-auto-mapping-tool\test-systems\ant\src\main\org\apache\tools\ant\taskdefs\optional\starteam\StarTeamList.java", "Java", 173, 0, 0, 0, 124, 42, 339
"c:\Users\zipasink\OneDrive\PhD\research\research-workspace\interactive-auto-mapping-tool\test-systems\ant\src\main\org\apache\tools\ant\taskdefs\optional\starteam\StarTeamTask.java", "Java", 127, 0, 0, 0, 197, 39, 363
"c:\Users\zipasink\OneDrive\PhD\research\research-workspace\interactive-auto-mapping-tool\test-systems\ant\src\main\org\apache\tools\ant\taskdefs\optional\starteam\TreeBasedTask.java", "Java", 318, 0, 0, 0, 453, 97, 868
"c:\Users\zipasink\OneDrive\PhD\research\research-workspace\interactive-auto-mapping-tool\test-systems\ant\src\main\org\apache\tools\ant\taskdefs\optional\unix\AbstractAccessTask.java", "Java", 35, 0, 0, 0, 62, 13, 110
"c:\Users\zipasink\OneDrive\PhD\research\research-workspace\interactive-auto-mapping-tool\test-systems\ant\src\main\org\apache\tools\ant\taskdefs\optional\unix\Chgrp.java", "Java", 24, 0, 0, 0, 51, 10, 85
"c:\Users\zipasink\OneDrive\PhD\research\research-workspace\interactive-auto-mapping-tool\test-systems\ant\src\main\org\apache\tools\ant\taskdefs\optional\unix\Chown.java", "Java", 24, 0, 0, 0, 51, 10, 85
"c:\Users\zipasink\OneDrive\PhD\research\research-workspace\interactive-auto-mapping-tool\test-systems\ant\src\main\org\apache\tools\ant\taskdefs\optional\unix\Symlink.java", "Java", 309, 0, 0, 0, 250, 34, 593
"c:\Users\zipasink\OneDrive\PhD\research\research-workspace\interactive-auto-mapping-tool\test-systems\ant\src\main\org\apache\tools\ant\taskdefs\optional\vss\MSVSS.java", "Java", 385, 0, 0, 0, 324, 69, 778
"c:\Users\zipasink\OneDrive\PhD\research\research-workspace\interactive-auto-mapping-tool\test-systems\ant\src\main\org\apache\tools\ant\taskdefs\optional\vss\MSVSSADD.java", "Java", 41, 0, 0, 0, 66, 16, 123
"c:\Users\zipasink\OneDrive\PhD\research\research-workspace\interactive-auto-mapping-tool\test-systems\ant\src\main\org\apache\tools\ant\taskdefs\optional\vss\MSVSSCHECKIN.java", "Java", 38, 0, 0, 0, 63, 14, 115
"c:\Users\zipasink\OneDrive\PhD\research\research-workspace\interactive-auto-mapping-tool\test-systems\ant\src\main\org\apache\tools\ant\taskdefs\optional\vss\MSVSSCHECKOUT.java", "Java", 52, 0, 0, 0, 96, 18, 166
"c:\Users\zipasink\OneDrive\PhD\research\research-workspace\interactive-auto-mapping-tool\test-systems\ant\src\main\org\apache\tools\ant\taskdefs\optional\vss\MSVSSCP.java", "Java", 21, 0, 0, 0, 39, 10, 70
"c:\Users\zipasink\OneDrive\PhD\research\research-workspace\interactive-auto-mapping-tool\test-systems\ant\src\main\org\apache\tools\ant\taskdefs\optional\vss\MSVSSCREATE.java", "Java", 29, 0, 0, 0, 51, 12, 92
"c:\Users\zipasink\OneDrive\PhD\research\research-workspace\interactive-auto-mapping-tool\test-systems\ant\src\main\org\apache\tools\ant\taskdefs\optional\vss\MSVSSConstants.java", "Java", 51, 0, 0, 0, 69, 7, 127
"c:\Users\zipasink\OneDrive\PhD\research\research-workspace\interactive-auto-mapping-tool\test-systems\ant\src\main\org\apache\tools\ant\taskdefs\optional\vss\MSVSSGET.java", "Java", 55, 0, 0, 0, 99, 19, 173
"c:\Users\zipasink\OneDrive\PhD\research\research-workspace\interactive-auto-mapping-tool\test-systems\ant\src\main\org\apache\tools\ant\taskdefs\optional\vss\MSVSSHISTORY.java", "Java", 74, 0, 0, 0, 105, 21, 200
"c:\Users\zipasink\OneDrive\PhD\research\research-workspace\interactive-auto-mapping-tool\test-systems\ant\src\main\org\apache\tools\ant\taskdefs\optional\vss\MSVSSLABEL.java", "Java", 37, 0, 0, 0, 58, 14, 109
"c:\Users\zipasink\OneDrive\PhD\research\research-workspace\interactive-auto-mapping-tool\test-systems\ant\src\main\org\apache\tools\ant\taskdefs\optional\windows\Attrib.java", "Java", 83, 0, 0, 0, 88, 25, 196
"c:\Users\zipasink\OneDrive\PhD\research\research-workspace\interactive-auto-mapping-tool\test-systems\ant\src\main\org\apache\tools\ant\taskdefs\rmic\DefaultRmicAdapter.java", "Java", 234, 0, 0, 0, 146, 48, 428
"c:\Users\zipasink\OneDrive\PhD\research\research-workspace\interactive-auto-mapping-tool\test-systems\ant\src\main\org\apache\tools\ant\taskdefs\rmic\ForkingSunRmic.java", "Java", 35, 0, 0, 0, 40, 11, 86
"c:\Users\zipasink\OneDrive\PhD\research\research-workspace\interactive-auto-mapping-tool\test-systems\ant\src\main\org\apache\tools\ant\taskdefs\rmic\KaffeRmic.java", "Java", 53, 0, 0, 0, 41, 11, 105
"c:\Users\zipasink\OneDrive\PhD\research\research-workspace\interactive-auto-mapping-tool\test-systems\ant\src\main\org\apache\tools\ant\taskdefs\rmic\RmicAdapter.java", "Java", 11, 0, 0, 0, 48, 9, 68
"c:\Users\zipasink\OneDrive\PhD\research\research-workspace\interactive-auto-mapping-tool\test-systems\ant\src\main\org\apache\tools\ant\taskdefs\rmic\RmicAdapterFactory.java", "Java", 38, 0, 0, 0, 57, 12, 107
"c:\Users\zipasink\OneDrive\PhD\research\research-workspace\interactive-auto-mapping-tool\test-systems\ant\src\main\org\apache\tools\ant\taskdefs\rmic\SunRmic.java", "Java", 53, 0, 0, 0, 40, 11, 104
"c:\Users\zipasink\OneDrive\PhD\research\research-workspace\interactive-auto-mapping-tool\test-systems\ant\src\main\org\apache\tools\ant\taskdefs\rmic\WLRmic.java", "Java", 56, 0, 0, 0, 44, 10, 110
"c:\Users\zipasink\OneDrive\PhD\research\research-workspace\interactive-auto-mapping-tool\test-systems\ant\src\main\org\apache\tools\ant\taskdefs\rmic\XNewRmic.java", "Java", 14, 0, 0, 0, 32, 7, 53
"c:\Users\zipasink\OneDrive\PhD\research\research-workspace\interactive-auto-mapping-tool\test-systems\ant\src\main\org\apache\tools\ant\types\AbstractFileSet.java", "Java", 414, 0, 0, 0, 330, 72, 816
"c:\Users\zipasink\OneDrive\PhD\research\research-workspace\interactive-auto-mapping-tool\test-systems\ant\src\main\org\apache\tools\ant\types\AntFilterReader.java", "Java", 73, 0, 0, 0, 69, 16, 158
"c:\Users\zipasink\OneDrive\PhD\research\research-workspace\interactive-auto-mapping-tool\test-systems\ant\src\main\org\apache\tools\ant\types\ArchiveFileSet.java", "Java", 234, 0, 0, 0, 221, 42, 497
"c:\Users\zipasink\OneDrive\PhD\research\research-workspace\interactive-auto-mapping-tool\test-systems\ant\src\main\org\apache\tools\ant\types\ArchiveScanner.java", "Java", 140, 0, 0, 0, 162, 34, 336
"c:\Users\zipasink\OneDrive\PhD\research\research-workspace\interactive-auto-mapping-tool\test-systems\ant\src\main\org\apache\tools\ant\types\Assertions.java", "Java", 151, 0, 0, 0, 179, 37, 367
"c:\Users\zipasink\OneDrive\PhD\research\research-workspace\interactive-auto-mapping-tool\test-systems\ant\src\main\org\apache\tools\ant\types\Commandline.java", "Java", 298, 0, 0, 0, 273, 50, 621
"c:\Users\zipasink\OneDrive\PhD\research\research-workspace\interactive-auto-mapping-tool\test-systems\ant\src\main\org\apache\tools\ant\types\CommandlineJava.java", "Java", 333, 0, 0, 0, 306, 61, 700
"c:\Users\zipasink\OneDrive\PhD\research\research-workspace\interactive-auto-mapping-tool\test-systems\ant\src\main\org\apache\tools\ant\types\Comparison.java", "Java", 33, 0, 0, 0, 46, 17, 96
"c:\Users\zipasink\OneDrive\PhD\research\research-workspace\interactive-auto-mapping-tool\test-systems\ant\src\main\org\apache\tools\ant\types\DTDLocation.java", "Java", 3, 0, 0, 0, 29, 2, 34
"c:\Users\zipasink\OneDrive\PhD\research\research-workspace\interactive-auto-mapping-tool\test-systems\ant\src\main\org\apache\tools\ant\types\DataType.java", "Java", 122, 0, 0, 0, 186, 32, 340
"c:\Users\zipasink\OneDrive\PhD\research\research-workspace\interactive-auto-mapping-tool\test-systems\ant\src\main\org\apache\tools\ant\types\Description.java", "Java", 66, 0, 0, 0, 45, 12, 123
"c:\Users\zipasink\OneDrive\PhD\research\research-workspace\interactive-auto-mapping-tool\test-systems\ant\src\main\org\apache\tools\ant\types\DirSet.java", "Java", 47, 0, 0, 0, 55, 13, 115
"c:\Users\zipasink\OneDrive\PhD\research\research-workspace\interactive-auto-mapping-tool\test-systems\ant\src\main\org\apache\tools\ant\types\EnumeratedAttribute.java", "Java", 57, 0, 0, 0, 81, 16, 154
"c:\Users\zipasink\OneDrive\PhD\research\research-workspace\interactive-auto-mapping-tool\test-systems\ant\src\main\org\apache\tools\ant\types\Environment.java", "Java", 61, 0, 0, 0, 95, 21, 177
"c:\Users\zipasink\OneDrive\PhD\research\research-workspace\interactive-auto-mapping-tool\test-systems\ant\src\main\org\apache\tools\ant\types\FileList.java", "Java", 95, 0, 0, 0, 101, 25, 221
"c:\Users\zipasink\OneDrive\PhD\research\research-workspace\interactive-auto-mapping-tool\test-systems\ant\src\main\org\apache\tools\ant\types\FileSet.java", "Java", 34, 0, 0, 0, 49, 12, 95
"c:\Users\zipasink\OneDrive\PhD\research\research-workspace\interactive-auto-mapping-tool\test-systems\ant\src\main\org\apache\tools\ant\types\FilterChain.java", "Java", 111, 0, 0, 0, 155, 34, 300
"c:\Users\zipasink\OneDrive\PhD\research\research-workspace\interactive-auto-mapping-tool\test-systems\ant\src\main\org\apache\tools\ant\types\FilterSet.java", "Java", 327, 0, 0, 0, 231, 58, 616
"c:\Users\zipasink\OneDrive\PhD\research\research-workspace\interactive-auto-mapping-tool\test-systems\ant\src\main\org\apache\tools\ant\types\FilterSetCollection.java", "Java", 31, 0, 0, 0, 49, 21, 101
"c:\Users\zipasink\OneDrive\PhD\research\research-workspace\interactive-auto-mapping-tool\test-systems\ant\src\main\org\apache\tools\ant\types\FlexInteger.java", "Java", 13, 0, 0, 0, 36, 6, 55
"c:\Users\zipasink\OneDrive\PhD\research\research-workspace\interactive-auto-mapping-tool\test-systems\ant\src\main\org\apache\tools\ant\types\LogLevel.java", "Java", 35, 0, 0, 0, 39, 14, 88
"c:\Users\zipasink\OneDrive\PhD\research\research-workspace\interactive-auto-mapping-tool\test-systems\ant\src\main\org\apache\tools\ant\types\Mapper.java", "Java", 170, 0, 0, 0, 102, 35, 307
"c:\Users\zipasink\OneDrive\PhD\research\research-workspace\interactive-auto-mapping-tool\test-systems\ant\src\main\org\apache\tools\ant\types\Parameter.java", "Java", 24, 0, 0, 0, 51, 8, 83
"c:\Users\zipasink\OneDrive\PhD\research\research-workspace\interactive-auto-mapping-tool\test-systems\ant\src\main\org\apache\tools\ant\types\Parameterizable.java", "Java", 4, 0, 0, 0, 26, 2, 32
"c:\Users\zipasink\OneDrive\PhD\research\research-workspace\interactive-auto-mapping-tool\test-systems\ant\src\main\org\apache\tools\ant\types\Path.java", "Java", 374, 0, 0, 0, 280, 64, 718
"c:\Users\zipasink\OneDrive\PhD\research\research-workspace\interactive-auto-mapping-tool\test-systems\ant\src\main\org\apache\tools\ant\types\PatternSet.java", "Java", 295, 0, 0, 0, 171, 47, 513
"c:\Users\zipasink\OneDrive\PhD\research\research-workspace\interactive-auto-mapping-tool\test-systems\ant\src\main\org\apache\tools\ant\types\Permissions.java", "Java", 182, 0, 0, 0, 126, 28, 336
"c:\Users\zipasink\OneDrive\PhD\research\research-workspace\interactive-auto-mapping-tool\test-systems\ant\src\main\org\apache\tools\ant\types\PropertySet.java", "Java", 281, 0, 0, 0, 181, 45, 507
"c:\Users\zipasink\OneDrive\PhD\research\research-workspace\interactive-auto-mapping-tool\test-systems\ant\src\main\org\apache\tools\ant\types\Quantifier.java", "Java", 66, 0, 0, 0, 60, 19, 145
"c:\Users\zipasink\OneDrive\PhD\research\research-workspace\interactive-auto-mapping-tool\test-systems\ant\src\main\org\apache\tools\ant\types\RedirectorElement.java", "Java", 366, 0, 0, 0, 190, 52, 608
"c:\Users\zipasink\OneDrive\PhD\research\research-workspace\interactive-auto-mapping-tool\test-systems\ant\src\main\org\apache\tools\ant\types\Reference.java", "Java", 44, 0, 0, 0, 75, 16, 135
"c:\Users\zipasink\OneDrive\PhD\research\research-workspace\interactive-auto-mapping-tool\test-systems\ant\src\main\org\apache\tools\ant\types\RegularExpression.java", "Java", 53, 0, 0, 0, 79, 10, 142
"c:\Users\zipasink\OneDrive\PhD\research\research-workspace\interactive-auto-mapping-tool\test-systems\ant\src\main\org\apache\tools\ant\types\Resource.java", "Java", 186, 0, 0, 0, 201, 37, 424
"c:\Users\zipasink\OneDrive\PhD\research\research-workspace\interactive-auto-mapping-tool\test-systems\ant\src\main\org\apache\tools\ant\types\ResourceCollection.java", "Java", 7, 0, 0, 0, 37, 7, 51
"c:\Users\zipasink\OneDrive\PhD\research\research-workspace\interactive-auto-mapping-tool\test-systems\ant\src\main\org\apache\tools\ant\types\ResourceFactory.java", "Java", 4, 0, 0, 0, 32, 3, 39
"c:\Users\zipasink\OneDrive\PhD\research\research-workspace\interactive-auto-mapping-tool\test-systems\ant\src\main\org\apache\tools\ant\types\ResourceLocation.java", "Java", 25, 0, 0, 0, 68, 14, 107
"c:\Users\zipasink\OneDrive\PhD\research\research-workspace\interactive-auto-mapping-tool\test-systems\ant\src\main\org\apache\tools\ant\types\Substitution.java", "Java", 21, 0, 0, 0, 47, 10, 78
"c:\Users\zipasink\OneDrive\PhD\research\research-workspace\interactive-auto-mapping-tool\test-systems\ant\src\main\org\apache\tools\ant\types\TarFileSet.java", "Java", 128, 0, 0, 0, 114, 27, 269
"c:\Users\zipasink\OneDrive\PhD\research\research-workspace\interactive-auto-mapping-tool\test-systems\ant\src\main\org\apache\tools\ant\types\TarScanner.java", "Java", 47, 0, 0, 0, 38, 7, 92
"c:\Users\zipasink\OneDrive\PhD\research\research-workspace\interactive-auto-mapping-tool\test-systems\ant\src\main\org\apache\tools\ant\types\TimeComparison.java", "Java", 43, 0, 0, 0, 64, 16, 123
"c:\Users\zipasink\OneDrive\PhD\research\research-workspace\interactive-auto-mapping-tool\test-systems\ant\src\main\org\apache\tools\ant\types\XMLCatalog.java", "Java", 551, 0, 0, 0, 415, 142, 1108
"c:\Users\zipasink\OneDrive\PhD\research\research-workspace\interactive-auto-mapping-tool\test-systems\ant\src\main\org\apache\tools\ant\types\ZipFileSet.java", "Java", 66, 0, 0, 0, 68, 14, 148
"c:\Users\zipasink\OneDrive\PhD\research\research-workspace\interactive-auto-mapping-tool\test-systems\ant\src\main\org\apache\tools\ant\types\ZipScanner.java", "Java", 59, 0, 0, 0, 38, 8, 105
"c:\Users\zipasink\OneDrive\PhD\research\research-workspace\interactive-auto-mapping-tool\test-systems\ant\src\main\org\apache\tools\ant\types\conditions\antlib.xml", "XML", 0, 0, 0, 53, 33, 2, 88
"c:\Users\zipasink\OneDrive\PhD\research\research-workspace\interactive-auto-mapping-tool\test-systems\ant\src\main\org\apache\tools\ant\types\defaults.properties", "Properties", 0, 63, 0, 0, 8, 6, 77
"c:\Users\zipasink\OneDrive\PhD\research\research-workspace\interactive-auto-mapping-tool\test-systems\ant\src\main\org\apache\tools\ant\types\mappers\FilterMapper.java", "Java", 42, 0, 0, 0, 36, 8, 86
"c:\Users\zipasink\OneDrive\PhD\research\research-workspace\interactive-auto-mapping-tool\test-systems\ant\src\main\org\apache\tools\ant\types\optional\AbstractScriptComponent.java", "Java", 51, 0, 0, 0, 78, 16, 145
"c:\Users\zipasink\OneDrive\PhD\research\research-workspace\interactive-auto-mapping-tool\test-systems\ant\src\main\org\apache\tools\ant\types\optional\ScriptCondition.java", "Java", 17, 0, 0, 0, 45, 8, 70
"c:\Users\zipasink\OneDrive\PhD\research\research-workspace\interactive-auto-mapping-tool\test-systems\ant\src\main\org\apache\tools\ant\types\optional\ScriptFilter.java", "Java", 57, 0, 0, 0, 94, 18, 169
"c:\Users\zipasink\OneDrive\PhD\research\research-workspace\interactive-auto-mapping-tool\test-systems\ant\src\main\org\apache\tools\ant\types\optional\ScriptMapper.java", "Java", 28, 0, 0, 0, 51, 15, 94
"c:\Users\zipasink\OneDrive\PhD\research\research-workspace\interactive-auto-mapping-tool\test-systems\ant\src\main\org\apache\tools\ant\types\optional\ScriptSelector.java", "Java", 78, 0, 0, 0, 121, 25, 224
"c:\Users\zipasink\OneDrive\PhD\research\research-workspace\interactive-auto-mapping-tool\test-systems\ant\src\main\org\apache\tools\ant\types\optional\depend\ClassfileSet.java", "Java", 65, 0, 0, 0, 84, 15, 164
"c:\Users\zipasink\OneDrive\PhD\research\research-workspace\interactive-auto-mapping-tool\test-systems\ant\src\main\org\apache\tools\ant\types\optional\depend\DependScanner.java", "Java", 93, 0, 0, 0, 97, 24, 214
"c:\Users\zipasink\OneDrive\PhD\research\research-workspace\interactive-auto-mapping-tool\test-systems\ant\src\main\org\apache\tools\ant\types\optional\image\Arc.java", "Java", 64, 0, 0, 0, 44, 14, 122
"c:\Users\zipasink\OneDrive\PhD\research\research-workspace\interactive-auto-mapping-tool\test-systems\ant\src\main\org\apache\tools\ant\types\optional\image\BasicShape.java", "Java", 15, 0, 0, 0, 34, 7, 56
"c:\Users\zipasink\OneDrive\PhD\research\research-workspace\interactive-auto-mapping-tool\test-systems\ant\src\main\org\apache\tools\ant\types\optional\image\ColorMapper.java", "Java", 53, 0, 0, 0, 45, 7, 105
"c:\Users\zipasink\OneDrive\PhD\research\research-workspace\interactive-auto-mapping-tool\test-systems\ant\src\main\org\apache\tools\ant\types\optional\image\Draw.java", "Java", 47, 0, 0, 0, 42, 12, 101
"c:\Users\zipasink\OneDrive\PhD\research\research-workspace\interactive-auto-mapping-tool\test-systems\ant\src\main\org\apache\tools\ant\types\optional\image\DrawOperation.java", "Java", 5, 0, 0, 0, 32, 3, 40
"c:\Users\zipasink\OneDrive\PhD\research\research-workspace\interactive-auto-mapping-tool\test-systems\ant\src\main\org\apache\tools\ant\types\optional\image\Ellipse.java", "Java", 43, 0, 0, 0, 32, 11, 86
"c:\Users\zipasink\OneDrive\PhD\research\research-workspace\interactive-auto-mapping-tool\test-systems\ant\src\main\org\apache\tools\ant\types\optional\image\ImageOperation.java", "Java", 21, 0, 0, 0, 43, 8, 72
"c:\Users\zipasink\OneDrive\PhD\research\research-workspace\interactive-auto-mapping-tool\test-systems\ant\src\main\org\apache\tools\ant\types\optional\image\Rectangle.java", "Java", 64, 0, 0, 0, 40, 14, 118
"c:\Users\zipasink\OneDrive\PhD\research\research-workspace\interactive-auto-mapping-tool\test-systems\ant\src\main\org\apache\tools\ant\types\optional\image\Rotate.java", "Java", 59, 0, 0, 0, 49, 11, 119
"c:\Users\zipasink\OneDrive\PhD\research\research-workspace\interactive-auto-mapping-tool\test-systems\ant\src\main\org\apache\tools\ant\types\optional\image\Scale.java", "Java", 105, 0, 0, 0, 53, 21, 179
"c:\Users\zipasink\OneDrive\PhD\research\research-workspace\interactive-auto-mapping-tool\test-systems\ant\src\main\org\apache\tools\ant\types\optional\image\Text.java", "Java", 62, 0, 0, 0, 49, 17, 128
"c:\Users\zipasink\OneDrive\PhD\research\research-workspace\interactive-auto-mapping-tool\test-systems\ant\src\main\org\apache\tools\ant\types\optional\image\TransformOperation.java", "Java", 8, 0, 0, 0, 27, 3, 38
"c:\Users\zipasink\OneDrive\PhD\research\research-workspace\interactive-auto-mapping-tool\test-systems\ant\src\main\org\apache\tools\ant\types\resolver\ApacheCatalog.java", "Java", 38, 0, 0, 0, 65, 19, 122
"c:\Users\zipasink\OneDrive\PhD\research\research-workspace\interactive-auto-mapping-tool\test-systems\ant\src\main\org\apache\tools\ant\types\resolver\ApacheCatalogResolver.java", "Java", 55, 0, 0, 0, 96, 27, 178
"c:\Users\zipasink\OneDrive\PhD\research\research-workspace\interactive-auto-mapping-tool\test-systems\ant\src\main\org\apache\tools\ant\types\resolver\package.html", "HTML", 0, 0, 14, 0, 16, 6, 36
"c:\Users\zipasink\OneDrive\PhD\research\research-workspace\interactive-auto-mapping-tool\test-systems\ant\src\main\org\apache\tools\ant\types\resources\ArchiveResource.java", "Java", 140, 0, 0, 0, 105, 25, 270
"c:\Users\zipasink\OneDrive\PhD\research\research-workspace\interactive-auto-mapping-tool\test-systems\ant\src\main\org\apache\tools\ant\types\resources\BCFileSet.java", "Java", 26, 0, 0, 0, 39, 8, 73
"c:\Users\zipasink\OneDrive\PhD\research\research-workspace\interactive-auto-mapping-tool\test-systems\ant\src\main\org\apache\tools\ant\types\resources\BZip2Resource.java", "Java", 31, 0, 0, 0, 46, 9, 86
"c:\Users\zipasink\OneDrive\PhD\research\research-workspace\interactive-auto-mapping-tool\test-systems\ant\src\main\org\apache\tools\ant\types\resources\BaseResourceCollectionContainer.java", "Java", 147, 0, 0, 0, 84, 19, 250
"c:\Users\zipasink\OneDrive\PhD\research\research-workspace\interactive-auto-mapping-tool\test-systems\ant\src\main\org\apache\tools\ant\types\resources\BaseResourceCollectionWrapper.java", "Java", 114, 0, 0, 0, 69, 19, 202
"c:\Users\zipasink\OneDrive\PhD\research\research-workspace\interactive-auto-mapping-tool\test-systems\ant\src\main\org\apache\tools\ant\types\resources\CompressedResource.java", "Java", 136, 0, 0, 0, 138, 31, 305
"c:\Users\zipasink\OneDrive\PhD\research\research-workspace\interactive-auto-mapping-tool\test-systems\ant\src\main\org\apache\tools\ant\types\resources\Difference.java", "Java", 35, 0, 0, 0, 26, 7, 68
"c:\Users\zipasink\OneDrive\PhD\research\research-workspace\interactive-auto-mapping-tool\test-systems\ant\src\main\org\apache\tools\ant\types\resources\FailFast.java", "Java", 75, 0, 0, 0, 45, 14, 134
"c:\Users\zipasink\OneDrive\PhD\research\research-workspace\interactive-auto-mapping-tool\test-systems\ant\src\main\org\apache\tools\ant\types\resources\FileResource.java", "Java", 169, 0, 0, 0, 126, 30, 325
"c:\Users\zipasink\OneDrive\PhD\research\research-workspace\interactive-auto-mapping-tool\test-systems\ant\src\main\org\apache\tools\ant\types\resources\FileResourceIterator.java", "Java", 42, 0, 0, 0, 54, 12, 108
"c:\Users\zipasink\OneDrive\PhD\research\research-workspace\interactive-auto-mapping-tool\test-systems\ant\src\main\org\apache\tools\ant\types\resources\Files.java", "Java", 279, 0, 0, 0, 184, 42, 505
"c:\Users\zipasink\OneDrive\PhD\research\research-workspace\interactive-auto-mapping-tool\test-systems\ant\src\main\org\apache\tools\ant\types\resources\First.java", "Java", 28, 0, 0, 0, 34, 9, 71
"c:\Users\zipasink\OneDrive\PhD\research\research-workspace\interactive-auto-mapping-tool\test-systems\ant\src\main\org\apache\tools\ant\types\resources\GZipResource.java", "Java", 22, 0, 0, 0, 46, 8, 76
"c:\Users\zipasink\OneDrive\PhD\research\research-workspace\interactive-auto-mapping-tool\test-systems\ant\src\main\org\apache\tools\ant\types\resources\ImmutableResourceException.java", "Java", 10, 0, 0, 0, 29, 7, 46
"c:\Users\zipasink\OneDrive\PhD\research\research-workspace\interactive-auto-mapping-tool\test-systems\ant\src\main\org\apache\tools\ant\types\resources\Intersect.java", "Java", 32, 0, 0, 0, 26, 6, 64
"c:\Users\zipasink\OneDrive\PhD\research\research-workspace\interactive-auto-mapping-tool\test-systems\ant\src\main\org\apache\tools\ant\types\resources\JavaResource.java", "Java", 115, 0, 0, 0, 79, 18, 212
"c:\Users\zipasink\OneDrive\PhD\research\research-workspace\interactive-auto-mapping-tool\test-systems\ant\src\main\org\apache\tools\ant\types\resources\PropertyResource.java", "Java", 63, 0, 0, 0, 69, 17, 149
"c:\Users\zipasink\OneDrive\PhD\research\research-workspace\interactive-auto-mapping-tool\test-systems\ant\src\main\org\apache\tools\ant\types\resources\Resources.java", "Java", 161, 0, 0, 0, 55, 20, 236
"c:\Users\zipasink\OneDrive\PhD\research\research-workspace\interactive-auto-mapping-tool\test-systems\ant\src\main\org\apache\tools\ant\types\resources\Restrict.java", "Java", 76, 0, 0, 0, 59, 14, 149
"c:\Users\zipasink\OneDrive\PhD\research\research-workspace\interactive-auto-mapping-tool\test-systems\ant\src\main\org\apache\tools\ant\types\resources\Sort.java", "Java", 99, 0, 0, 0, 38, 11, 148
"c:\Users\zipasink\OneDrive\PhD\research\research-workspace\interactive-auto-mapping-tool\test-systems\ant\src\main\org\apache\tools\ant\types\resources\StringResource.java", "Java", 98, 0, 0, 0, 96, 23, 217
"c:\Users\zipasink\OneDrive\PhD\research\research-workspace\interactive-auto-mapping-tool\test-systems\ant\src\main\org\apache\tools\ant\types\resources\TarResource.java", "Java", 112, 0, 0, 0, 65, 18, 195
"c:\Users\zipasink\OneDrive\PhD\research\research-workspace\interactive-auto-mapping-tool\test-systems\ant\src\main\org\apache\tools\ant\types\resources\Tokens.java", "Java", 76, 0, 0, 0, 42, 11, 129
"c:\Users\zipasink\OneDrive\PhD\research\research-workspace\interactive-auto-mapping-tool\test-systems\ant\src\main\org\apache\tools\ant\types\resources\Touchable.java", "Java", 4, 0, 0, 0, 27, 2, 33
"c:\Users\zipasink\OneDrive\PhD\research\research-workspace\interactive-auto-mapping-tool\test-systems\ant\src\main\org\apache\tools\ant\types\resources\URLResource.java", "Java", 199, 0, 0, 0, 139, 30, 368
"c:\Users\zipasink\OneDrive\PhD\research\research-workspace\interactive-auto-mapping-tool\test-systems\ant\src\main\org\apache\tools\ant\types\resources\Union.java", "Java", 57, 0, 0, 0, 53, 13, 123
"c:\Users\zipasink\OneDrive\PhD\research\research-workspace\interactive-auto-mapping-tool\test-systems\ant\src\main\org\apache\tools\ant\types\resources\ZipResource.java", "Java", 112, 0, 0, 0, 74, 18, 204
"c:\Users\zipasink\OneDrive\PhD\research\research-workspace\interactive-auto-mapping-tool\test-systems\ant\src\main\org\apache\tools\ant\types\resources\comparators\Content.java", "Java", 21, 0, 0, 0, 41, 9, 71
"c:\Users\zipasink\OneDrive\PhD\research\research-workspace\interactive-auto-mapping-tool\test-systems\ant\src\main\org\apache\tools\ant\types\resources\comparators\Date.java", "Java", 7, 0, 0, 0, 28, 4, 39
"c:\Users\zipasink\OneDrive\PhD\research\research-workspace\interactive-auto-mapping-tool\test-systems\ant\src\main\org\apache\tools\ant\types\resources\comparators\DelegatedResourceComparator.java", "Java", 70, 0, 0, 0, 45, 10, 125
"c:\Users\zipasink\OneDrive\PhD\research\research-workspace\interactive-auto-mapping-tool\test-systems\ant\src\main\org\apache\tools\ant\types\resources\comparators\Exists.java", "Java", 11, 0, 0, 0, 28, 5, 44
"c:\Users\zipasink\OneDrive\PhD\research\research-workspace\interactive-auto-mapping-tool\test-systems\ant\src\main\org\apache\tools\ant\types\resources\comparators\FileSystem.java", "Java", 16, 0, 0, 0, 29, 5, 50
"c:\Users\zipasink\OneDrive\PhD\research\research-workspace\interactive-auto-mapping-tool\test-systems\ant\src\main\org\apache\tools\ant\types\resources\comparators\Name.java", "Java", 7, 0, 0, 0, 28, 4, 39
"c:\Users\zipasink\OneDrive\PhD\research\research-workspace\interactive-auto-mapping-tool\test-systems\ant\src\main\org\apache\tools\ant\types\resources\comparators\ResourceComparator.java", "Java", 28, 0, 0, 0, 45, 9, 82
"c:\Users\zipasink\OneDrive\PhD\research\research-workspace\interactive-auto-mapping-tool\test-systems\ant\src\main\org\apache\tools\ant\types\resources\comparators\Reverse.java", "Java", 23, 0, 0, 0, 40, 9, 72
"c:\Users\zipasink\OneDrive\PhD\research\research-workspace\interactive-auto-mapping-tool\test-systems\ant\src\main\org\apache\tools\ant\types\resources\comparators\Size.java", "Java", 7, 0, 0, 0, 28, 4, 39
"c:\Users\zipasink\OneDrive\PhD\research\research-workspace\interactive-auto-mapping-tool\test-systems\ant\src\main\org\apache\tools\ant\types\resources\comparators\Type.java", "Java", 11, 0, 0, 0, 29, 5, 45
"c:\Users\zipasink\OneDrive\PhD\research\research-workspace\interactive-auto-mapping-tool\test-systems\ant\src\main\org\apache\tools\ant\types\resources\selectors\And.java", "Java", 18, 0, 0, 0, 33, 8, 59
"c:\Users\zipasink\OneDrive\PhD\research\research-workspace\interactive-auto-mapping-tool\test-systems\ant\src\main\org\apache\tools\ant\types\resources\selectors\Compare.java", "Java", 84, 0, 0, 0, 49, 15, 148
"c:\Users\zipasink\OneDrive\PhD\research\research-workspace\interactive-auto-mapping-tool\test-systems\ant\src\main\org\apache\tools\ant\types\resources\selectors\Date.java", "Java", 76, 0, 0, 0, 70, 17, 163
"c:\Users\zipasink\OneDrive\PhD\research\research-workspace\interactive-auto-mapping-tool\test-systems\ant\src\main\org\apache\tools\ant\types\resources\selectors\Exists.java", "Java", 7, 0, 0, 0, 26, 5, 38
"c:\Users\zipasink\OneDrive\PhD\research\research-workspace\interactive-auto-mapping-tool\test-systems\ant\src\main\org\apache\tools\ant\types\resources\selectors\InstanceOf.java", "Java", 62, 0, 0, 0, 55, 14, 131
"c:\Users\zipasink\OneDrive\PhD\research\research-workspace\interactive-auto-mapping-tool\test-systems\ant\src\main\org\apache\tools\ant\types\resources\selectors\Majority.java", "Java", 36, 0, 0, 0, 38, 11, 85
"c:\Users\zipasink\OneDrive\PhD\research\research-workspace\interactive-auto-mapping-tool\test-systems\ant\src\main\org\apache\tools\ant\types\resources\selectors\Name.java", "Java", 27, 0, 0, 0, 42, 9, 78
"c:\Users\zipasink\OneDrive\PhD\research\research-workspace\interactive-auto-mapping-tool\test-systems\ant\src\main\org\apache\tools\ant\types\resources\selectors\None.java", "Java", 18, 0, 0, 0, 33, 8, 59
"c:\Users\zipasink\OneDrive\PhD\research\research-workspace\interactive-auto-mapping-tool\test-systems\ant\src\main\org\apache\tools\ant\types\resources\selectors\Not.java", "Java", 20, 0, 0, 0, 38, 9, 67
"c:\Users\zipasink\OneDrive\PhD\research\research-workspace\interactive-auto-mapping-tool\test-systems\ant\src\main\org\apache\tools\ant\types\resources\selectors\Or.java", "Java", 18, 0, 0, 0, 33, 8, 59
"c:\Users\zipasink\OneDrive\PhD\research\research-workspace\interactive-auto-mapping-tool\test-systems\ant\src\main\org\apache\tools\ant\types\resources\selectors\ResourceSelector.java", "Java", 5, 0, 0, 0, 26, 5, 36
"c:\Users\zipasink\OneDrive\PhD\research\research-workspace\interactive-auto-mapping-tool\test-systems\ant\src\main\org\apache\tools\ant\types\resources\selectors\ResourceSelectorContainer.java", "Java", 67, 0, 0, 0, 50, 13, 130
"c:\Users\zipasink\OneDrive\PhD\research\research-workspace\interactive-auto-mapping-tool\test-systems\ant\src\main\org\apache\tools\ant\types\resources\selectors\Size.java", "Java", 23, 0, 0, 0, 42, 9, 74
"c:\Users\zipasink\OneDrive\PhD\research\research-workspace\interactive-auto-mapping-tool\test-systems\ant\src\main\org\apache\tools\ant\types\resources\selectors\Type.java", "Java", 37, 0, 0, 0, 53, 16, 106
"c:\Users\zipasink\OneDrive\PhD\research\research-workspace\interactive-auto-mapping-tool\test-systems\ant\src\main\org\apache\tools\ant\types\selectors\AbstractSelectorContainer.java", "Java", 106, 0, 0, 0, 147, 36, 289
"c:\Users\zipasink\OneDrive\PhD\research\research-workspace\interactive-auto-mapping-tool\test-systems\ant\src\main\org\apache\tools\ant\types\selectors\AndSelector.java", "Java", 29, 0, 0, 0, 39, 10, 78
"c:\Users\zipasink\OneDrive\PhD\research\research-workspace\interactive-auto-mapping-tool\test-systems\ant\src\main\org\apache\tools\ant\types\selectors\BaseExtendSelector.java", "Java", 20, 0, 0, 0, 55, 13, 88
"c:\Users\zipasink\OneDrive\PhD\research\research-workspace\interactive-auto-mapping-tool\test-systems\ant\src\main\org\apache\tools\ant\types\selectors\BaseSelector.java", "Java", 32, 0, 0, 0, 61, 18, 111
"c:\Users\zipasink\OneDrive\PhD\research\research-workspace\interactive-auto-mapping-tool\test-systems\ant\src\main\org\apache\tools\ant\types\selectors\BaseSelectorContainer.java", "Java", 116, 0, 0, 0, 159, 39, 314
"c:\Users\zipasink\OneDrive\PhD\research\research-workspace\interactive-auto-mapping-tool\test-systems\ant\src\main\org\apache\tools\ant\types\selectors\ContainsRegexpSelector.java", "Java", 92, 0, 0, 0, 59, 22, 173
"c:\Users\zipasink\OneDrive\PhD\research\research-workspace\interactive-auto-mapping-tool\test-systems\ant\src\main\org\apache\tools\ant\types\selectors\ContainsSelector.java", "Java", 109, 0, 0, 0, 78, 21, 208
"c:\Users\zipasink\OneDrive\PhD\research\research-workspace\interactive-auto-mapping-tool\test-systems\ant\src\main\org\apache\tools\ant\types\selectors\DateSelector.java", "Java", 134, 0, 0, 0, 101, 28, 263
"c:\Users\zipasink\OneDrive\PhD\research\research-workspace\interactive-auto-mapping-tool\test-systems\ant\src\main\org\apache\tools\ant\types\selectors\DependSelector.java", "Java", 30, 0, 0, 0, 38, 11, 79
"c:\Users\zipasink\OneDrive\PhD\research\research-workspace\interactive-auto-mapping-tool\test-systems\ant\src\main\org\apache\tools\ant\types\selectors\DepthSelector.java", "Java", 95, 0, 0, 0, 71, 20, 186
"c:\Users\zipasink\OneDrive\PhD\research\research-workspace\interactive-auto-mapping-tool\test-systems\ant\src\main\org\apache\tools\ant\types\selectors\DifferentSelector.java", "Java", 42, 0, 0, 0, 60, 13, 115
"c:\Users\zipasink\OneDrive\PhD\research\research-workspace\interactive-auto-mapping-tool\test-systems\ant\src\main\org\apache\tools\ant\types\selectors\ExtendFileSelector.java", "Java", 4, 0, 0, 0, 30, 6, 40
"c:\Users\zipasink\OneDrive\PhD\research\research-workspace\interactive-auto-mapping-tool\test-systems\ant\src\main\org\apache\tools\ant\types\selectors\ExtendSelector.java", "Java", 105, 0, 0, 0, 76, 20, 201
"c:\Users\zipasink\OneDrive\PhD\research\research-workspace\interactive-auto-mapping-tool\test-systems\ant\src\main\org\apache\tools\ant\types\selectors\FileSelector.java", "Java", 7, 0, 0, 0, 34, 8, 49
"c:\Users\zipasink\OneDrive\PhD\research\research-workspace\interactive-auto-mapping-tool\test-systems\ant\src\main\org\apache\tools\ant\types\selectors\FilenameSelector.java", "Java", 74, 0, 0, 0, 75, 18, 167
"c:\Users\zipasink\OneDrive\PhD\research\research-workspace\interactive-auto-mapping-tool\test-systems\ant\src\main\org\apache\tools\ant\types\selectors\MajoritySelector.java", "Java", 42, 0, 0, 0, 53, 11, 106
"c:\Users\zipasink\OneDrive\PhD\research\research-workspace\interactive-auto-mapping-tool\test-systems\ant\src\main\org\apache\tools\ant\types\selectors\MappingSelector.java", "Java", 59, 0, 0, 0, 69, 21, 149
"c:\Users\zipasink\OneDrive\PhD\research\research-workspace\interactive-auto-mapping-tool\test-systems\ant\src\main\org\apache\tools\ant\types\selectors\NoneSelector.java", "Java", 29, 0, 0, 0, 40, 10, 79
"c:\Users\zipasink\OneDrive\PhD\research\research-workspace\interactive-auto-mapping-tool\test-systems\ant\src\main\org\apache\tools\ant\types\selectors\NotSelector.java", "Java", 24, 0, 0, 0, 40, 10, 74
"c:\Users\zipasink\OneDrive\PhD\research\research-workspace\interactive-auto-mapping-tool\test-systems\ant\src\main\org\apache\tools\ant\types\selectors\OrSelector.java", "Java", 29, 0, 0, 0, 40, 10, 79
"c:\Users\zipasink\OneDrive\PhD\research\research-workspace\interactive-auto-mapping-tool\test-systems\ant\src\main\org\apache\tools\ant\types\selectors\PresentSelector.java", "Java", 83, 0, 0, 0, 80, 19, 182
"c:\Users\zipasink\OneDrive\PhD\research\research-workspace\interactive-auto-mapping-tool\test-systems\ant\src\main\org\apache\tools\ant\types\selectors\SelectSelector.java", "Java", 97, 0, 0, 0, 92, 23, 212
"c:\Users\zipasink\OneDrive\PhD\research\research-workspace\interactive-auto-mapping-tool\test-systems\ant\src\main\org\apache\tools\ant\types\selectors\SelectorContainer.java", "Java", 30, 0, 0, 0, 128, 29, 187
"c:\Users\zipasink\OneDrive\PhD\research\research-workspace\interactive-auto-mapping-tool\test-systems\ant\src\main\org\apache\tools\ant\types\selectors\SelectorScanner.java", "Java", 6, 0, 0, 0, 38, 6, 50
"c:\Users\zipasink\OneDrive\PhD\research\research-workspace\interactive-auto-mapping-tool\test-systems\ant\src\main\org\apache\tools\ant\types\selectors\SelectorUtils.java", "Java", 402, 0, 0, 0, 234, 48, 684
"c:\Users\zipasink\OneDrive\PhD\research\research-workspace\interactive-auto-mapping-tool\test-systems\ant\src\main\org\apache\tools\ant\types\selectors\SignedSelector.java", "Java", 18, 0, 0, 0, 36, 5, 59
"c:\Users\zipasink\OneDrive\PhD\research\research-workspace\interactive-auto-mapping-tool\test-systems\ant\src\main\org\apache\tools\ant\types\selectors\SizeSelector.java", "Java", 115, 0, 0, 0, 126, 22, 263
"c:\Users\zipasink\OneDrive\PhD\research\research-workspace\interactive-auto-mapping-tool\test-systems\ant\src\main\org\apache\tools\ant\types\selectors\TypeSelector.java", "Java", 54, 0, 0, 0, 63, 19, 136
"c:\Users\zipasink\OneDrive\PhD\research\research-workspace\interactive-auto-mapping-tool\test-systems\ant\src\main\org\apache\tools\ant\types\selectors\modifiedselector\Algorithm.java", "Java", 6, 0, 0, 0, 35, 8, 49
"c:\Users\zipasink\OneDrive\PhD\research\research-workspace\interactive-auto-mapping-tool\test-systems\ant\src\main\org\apache\tools\ant\types\selectors\modifiedselector\Cache.java", "Java", 11, 0, 0, 0, 49, 13, 73
"c:\Users\zipasink\OneDrive\PhD\research\research-workspace\interactive-auto-mapping-tool\test-systems\ant\src\main\org\apache\tools\ant\types\selectors\modifiedselector\ChecksumAlgorithm.java", "Java", 58, 0, 0, 0, 66, 26, 150
"c:\Users\zipasink\OneDrive\PhD\research\research-workspace\interactive-auto-mapping-tool\test-systems\ant\src\main\org\apache\tools\ant\types\selectors\modifiedselector\DigestAlgorithm.java", "Java", 88, 0, 0, 0, 84, 31, 203
"c:\Users\zipasink\OneDrive\PhD\research\research-workspace\interactive-auto-mapping-tool\test-systems\ant\src\main\org\apache\tools\ant\types\selectors\modifiedselector\EqualComparator.java", "Java", 16, 0, 0, 0, 35, 8, 59
"c:\Users\zipasink\OneDrive\PhD\research\research-workspace\interactive-auto-mapping-tool\test-systems\ant\src\main\org\apache\tools\ant\types\selectors\modifiedselector\HashvalueAlgorithm.java", "Java", 26, 0, 0, 0, 43, 11, 80
"c:\Users\zipasink\OneDrive\PhD\research\research-workspace\interactive-auto-mapping-tool\test-systems\ant\src\main\org\apache\tools\ant\types\selectors\modifiedselector\ModifiedSelector.java", "Java", 391, 0, 0, 0, 428, 140, 959
"c:\Users\zipasink\OneDrive\PhD\research\research-workspace\interactive-auto-mapping-tool\test-systems\ant\src\main\org\apache\tools\ant\types\selectors\modifiedselector\PropertiesfileCache.java", "Java", 97, 0, 0, 0, 99, 41, 237
"c:\Users\zipasink\OneDrive\PhD\research\research-workspace\interactive-auto-mapping-tool\test-systems\ant\src\main\org\apache\tools\ant\types\spi\Provider.java", "Java", 23, 0, 0, 0, 35, 6, 64
"c:\Users\zipasink\OneDrive\PhD\research\research-workspace\interactive-auto-mapping-tool\test-systems\ant\src\main\org\apache\tools\ant\types\spi\Service.java", "Java", 63, 0, 0, 0, 51, 11, 125
"c:\Users\zipasink\OneDrive\PhD\research\research-workspace\interactive-auto-mapping-tool\test-systems\ant\src\main\org\apache\tools\ant\util\Base64Converter.java", "Java", 56, 0, 0, 0, 41, 12, 109
"c:\Users\zipasink\OneDrive\PhD\research\research-workspace\interactive-auto-mapping-tool\test-systems\ant\src\main\org\apache\tools\ant\util\ChainedMapper.java", "Java", 29, 0, 0, 0, 24, 8, 61
"c:\Users\zipasink\OneDrive\PhD\research\research-workspace\interactive-auto-mapping-tool\test-systems\ant\src\main\org\apache\tools\ant\util\ClasspathUtils.java", "Java", 184, 0, 0, 0, 280, 36, 500
"c:\Users\zipasink\OneDrive\PhD\research\research-workspace\interactive-auto-mapping-tool\test-systems\ant\src\main\org\apache\tools\ant\util\CollectionUtils.java", "Java", 97, 0, 0, 0, 81, 27, 205
"c:\Users\zipasink\OneDrive\PhD\research\research-workspace\interactive-auto-mapping-tool\test-systems\ant\src\main\org\apache\tools\ant\util\CompositeMapper.java", "Java", 21, 0, 0, 0, 22, 7, 50
"c:\Users\zipasink\OneDrive\PhD\research\research-workspace\interactive-auto-mapping-tool\test-systems\ant\src\main\org\apache\tools\ant\util\ConcatFileInputStream.java", "Java", 71, 0, 0, 0, 51, 15, 137
"c:\Users\zipasink\OneDrive\PhD\research\research-workspace\interactive-auto-mapping-tool\test-systems\ant\src\main\org\apache\tools\ant\util\ConcatResourceInputStream.java", "Java", 78, 0, 0, 0, 54, 16, 148
"c:\Users\zipasink\OneDrive\PhD\research\research-workspace\interactive-auto-mapping-tool\test-systems\ant\src\main\org\apache\tools\ant\util\ContainerMapper.java", "Java", 42, 0, 0, 0, 63, 14, 119
"c:\Users\zipasink\OneDrive\PhD\research\research-workspace\interactive-auto-mapping-tool\test-systems\ant\src\main\org\apache\tools\ant\util\DOMElementWriter.java", "Java", 334, 0, 0, 0, 192, 52, 578
"c:\Users\zipasink\OneDrive\PhD\research\research-workspace\interactive-auto-mapping-tool\test-systems\ant\src\main\org\apache\tools\ant\util\DOMUtils.java", "Java", 36, 0, 0, 0, 122, 11, 169
"c:\Users\zipasink\OneDrive\PhD\research\research-workspace\interactive-auto-mapping-tool\test-systems\ant\src\main\org\apache\tools\ant\util\DateUtils.java", "Java", 102, 0, 0, 0, 142, 28, 272
"c:\Users\zipasink\OneDrive\PhD\research\research-workspace\interactive-auto-mapping-tool\test-systems\ant\src\main\org\apache\tools\ant\util\DeweyDecimal.java", "Java", 91, 0, 0, 0, 91, 31, 213
"c:\Users\zipasink\OneDrive\PhD\research\research-workspace\interactive-auto-mapping-tool\test-systems\ant\src\main\org\apache\tools\ant\util\FileNameMapper.java", "Java", 6, 0, 0, 0, 49, 6, 61
"c:\Users\zipasink\OneDrive\PhD\research\research-workspace\interactive-auto-mapping-tool\test-systems\ant\src\main\org\apache\tools\ant\util\FileTokenizer.java", "Java", 12, 0, 0, 0, 31, 5, 48
"c:\Users\zipasink\OneDrive\PhD\research\research-workspace\interactive-auto-mapping-tool\test-systems\ant\src\main\org\apache\tools\ant\util\FileUtils.java", "Java", 618, 0, 0, 0, 816, 98, 1532
"c:\Users\zipasink\OneDrive\PhD\research\research-workspace\interactive-auto-mapping-tool\test-systems\ant\src\main\org\apache\tools\ant\util\FlatFileNameMapper.java", "Java", 10, 0, 0, 0, 39, 6, 55
"c:\Users\zipasink\OneDrive\PhD\research\research-workspace\interactive-auto-mapping-tool\test-systems\ant\src\main\org\apache\tools\ant\util\GlobPatternMapper.java", "Java", 64, 0, 0, 0, 89, 18, 171
"c:\Users\zipasink\OneDrive\PhD\research\research-workspace\interactive-auto-mapping-tool\test-systems\ant\src\main\org\apache\tools\ant\util\IdentityMapper.java", "Java", 10, 0, 0, 0, 37, 6, 53
"c:\Users\zipasink\OneDrive\PhD\research\research-workspace\interactive-auto-mapping-tool\test-systems\ant\src\main\org\apache\tools\ant\util\IdentityStack.java", "Java", 39, 0, 0, 0, 54, 10, 103
"c:\Users\zipasink\OneDrive\PhD\research\research-workspace\interactive-auto-mapping-tool\test-systems\ant\src\main\org\apache\tools\ant\util\JAXPUtils.java", "Java", 106, 0, 0, 0, 130, 23, 259
"c:\Users\zipasink\OneDrive\PhD\research\research-workspace\interactive-auto-mapping-tool\test-systems\ant\src\main\org\apache\tools\ant\util\JavaEnvUtils.java", "Java", 223, 0, 0, 0, 182, 39, 444
"c:\Users\zipasink\OneDrive\PhD\research\research-workspace\interactive-auto-mapping-tool\test-systems\ant\src\main\org\apache\tools\ant\util\KeepAliveInputStream.java", "Java", 11, 0, 0, 0, 42, 5, 58
"c:\Users\zipasink\OneDrive\PhD\research\research-workspace\interactive-auto-mapping-tool\test-systems\ant\src\main\org\apache\tools\ant\util\KeepAliveOutputStream.java", "Java", 11, 0, 0, 0, 41, 5, 57
"c:\Users\zipasink\OneDrive\PhD\research\research-workspace\interactive-auto-mapping-tool\test-systems\ant\src\main\org\apache\tools\ant\util\LazyFileOutputStream.java", "Java", 64, 0, 0, 0, 83, 16, 163
"c:\Users\zipasink\OneDrive\PhD\research\research-workspace\interactive-auto-mapping-tool\test-systems\ant\src\main\org\apache\tools\ant\util\LazyHashtable.java", "Java", 42, 0, 0, 0, 65, 14, 121
"c:\Users\zipasink\OneDrive\PhD\research\research-workspace\interactive-auto-mapping-tool\test-systems\ant\src\main\org\apache\tools\ant\util\LeadPipeInputStream.java", "Java", 75, 0, 0, 0, 69, 15, 159
"c:\Users\zipasink\OneDrive\PhD\research\research-workspace\interactive-auto-mapping-tool\test-systems\ant\src\main\org\apache\tools\ant\util\LineOrientedOutputStream.java", "Java", 63, 0, 0, 0, 63, 15, 141
"c:\Users\zipasink\OneDrive\PhD\research\research-workspace\interactive-auto-mapping-tool\test-systems\ant\src\main\org\apache\tools\ant\util\LineTokenizer.java", "Java", 63, 0, 0, 0, 39, 13, 115
"c:\Users\zipasink\OneDrive\PhD\research\research-workspace\interactive-auto-mapping-tool\test-systems\ant\src\main\org\apache\tools\ant\util\LoaderUtils.java", "Java", 42, 0, 0, 0, 82, 16, 140
"c:\Users\zipasink\OneDrive\PhD\research\research-workspace\interactive-auto-mapping-tool\test-systems\ant\src\main\org\apache\tools\ant\util\MergingMapper.java", "Java", 12, 0, 0, 0, 40, 7, 59
"c:\Users\zipasink\OneDrive\PhD\research\research-workspace\interactive-auto-mapping-tool\test-systems\ant\src\main\org\apache\tools\ant\util\OutputStreamFunneler.java", "Java", 99, 0, 0, 0, 57, 21, 177
"c:\Users\zipasink\OneDrive\PhD\research\research-workspace\interactive-auto-mapping-tool\test-systems\ant\src\main\org\apache\tools\ant\util\PackageNameMapper.java", "Java", 9, 0, 0, 0, 34, 4, 47
"c:\Users\zipasink\OneDrive\PhD\research\research-workspace\interactive-auto-mapping-tool\test-systems\ant\src\main\org\apache\tools\ant\util\PropertyOutputStream.java", "Java", 22, 0, 0, 0, 38, 10, 70
"c:\Users\zipasink\OneDrive\PhD\research\research-workspace\interactive-auto-mapping-tool\test-systems\ant\src\main\org\apache\tools\ant\util\ProxySetup.java", "Java", 46, 0, 0, 0, 61, 12, 119
"c:\Users\zipasink\OneDrive\PhD\research\research-workspace\interactive-auto-mapping-tool\test-systems\ant\src\main\org\apache\tools\ant\util\ReaderInputStream.java", "Java", 106, 0, 0, 0, 77, 23, 206
"c:\Users\zipasink\OneDrive\PhD\research\research-workspace\interactive-auto-mapping-tool\test-systems\ant\src\main\org\apache\tools\ant\util\ReflectUtil.java", "Java", 69, 0, 0, 0, 61, 10, 140
"c:\Users\zipasink\OneDrive\PhD\research\research-workspace\interactive-auto-mapping-tool\test-systems\ant\src\main\org\apache\tools\ant\util\ReflectWrapper.java", "Java", 35, 0, 0, 0, 56, 9, 100
"c:\Users\zipasink\OneDrive\PhD\research\research-workspace\interactive-auto-mapping-tool\test-systems\ant\src\main\org\apache\tools\ant\util\RegexpPatternMapper.java", "Java", 69, 0, 0, 0, 68, 14, 151
"c:\Users\zipasink\OneDrive\PhD\research\research-workspace\interactive-auto-mapping-tool\test-systems\ant\src\main\org\apache\tools\ant\util\ResourceUtils.java", "Java", 351, 0, 0, 0, 197, 25, 573
"c:\Users\zipasink\OneDrive\PhD\research\research-workspace\interactive-auto-mapping-tool\test-systems\ant\src\main\org\apache\tools\ant\util\RetryHandler.java", "Java", 32, 0, 0, 0, 35, 8, 75
"c:\Users\zipasink\OneDrive\PhD\research\research-workspace\interactive-auto-mapping-tool\test-systems\ant\src\main\org\apache\tools\ant\util\Retryable.java", "Java", 6, 0, 0, 0, 28, 5, 39
"c:\Users\zipasink\OneDrive\PhD\research\research-workspace\interactive-auto-mapping-tool\test-systems\ant\src\main\org\apache\tools\ant\util\ScriptRunner.java", "Java", 4, 0, 0, 0, 22, 2, 28
"c:\Users\zipasink\OneDrive\PhD\research\research-workspace\interactive-auto-mapping-tool\test-systems\ant\src\main\org\apache\tools\ant\util\ScriptRunnerBase.java", "Java", 126, 0, 0, 0, 145, 37, 308
"c:\Users\zipasink\OneDrive\PhD\research\research-workspace\interactive-auto-mapping-tool\test-systems\ant\src\main\org\apache\tools\ant\util\ScriptRunnerCreator.java", "Java", 77, 0, 0, 0, 49, 13, 139
"c:\Users\zipasink\OneDrive\PhD\research\research-workspace\interactive-auto-mapping-tool\test-systems\ant\src\main\org\apache\tools\ant\util\ScriptRunnerHelper.java", "Java", 85, 0, 0, 0, 86, 21, 192
"c:\Users\zipasink\OneDrive\PhD\research\research-workspace\interactive-auto-mapping-tool\test-systems\ant\src\main\org\apache\tools\ant\util\SourceFileScanner.java", "Java", 57, 0, 0, 0, 98, 15, 170
"c:\Users\zipasink\OneDrive\PhD\research\research-workspace\interactive-auto-mapping-tool\test-systems\ant\src\main\org\apache\tools\ant\util\StringTokenizer.java", "Java", 87, 0, 0, 0, 56, 10, 153
"c:\Users\zipasink\OneDrive\PhD\research\research-workspace\interactive-auto-mapping-tool\test-systems\ant\src\main\org\apache\tools\ant\util\StringUtils.java", "Java", 124, 0, 0, 0, 91, 12, 227
"c:\Users\zipasink\OneDrive\PhD\research\research-workspace\interactive-auto-mapping-tool\test-systems\ant\src\main\org\apache\tools\ant\util\TaskLogger.java", "Java", 24, 0, 0, 0, 47, 9, 80
"c:\Users\zipasink\OneDrive\PhD\research\research-workspace\interactive-auto-mapping-tool\test-systems\ant\src\main\org\apache\tools\ant\util\TeeOutputStream.java", "Java", 34, 0, 0, 0, 51, 11, 96
"c:\Users\zipasink\OneDrive\PhD\research\research-workspace\interactive-auto-mapping-tool\test-systems\ant\src\main\org\apache\tools\ant\util\TimeoutObserver.java", "Java", 4, 0, 0, 0, 30, 4, 38
"c:\Users\zipasink\OneDrive\PhD\research\research-workspace\interactive-auto-mapping-tool\test-systems\ant\src\main\org\apache\tools\ant\util\Tokenizer.java", "Java", 7, 0, 0, 0, 34, 4, 45
"c:\Users\zipasink\OneDrive\PhD\research\research-workspace\interactive-auto-mapping-tool\test-systems\ant\src\main\org\apache\tools\ant\util\UUEncoder.java", "Java", 73, 0, 0, 0, 57, 14, 144
"c:\Users\zipasink\OneDrive\PhD\research\research-workspace\interactive-auto-mapping-tool\test-systems\ant\src\main\org\apache\tools\ant\util\UnPackageNameMapper.java", "Java", 9, 0, 0, 0, 36, 4, 49
"c:\Users\zipasink\OneDrive\PhD\research\research-workspace\interactive-auto-mapping-tool\test-systems\ant\src\main\org\apache\tools\ant\util\Watchdog.java", "Java", 50, 0, 0, 0, 64, 13, 127
"c:\Users\zipasink\OneDrive\PhD\research\research-workspace\interactive-auto-mapping-tool\test-systems\ant\src\main\org\apache\tools\ant\util\WeakishReference.java", "Java", 19, 0, 0, 0, 58, 15, 92
"c:\Users\zipasink\OneDrive\PhD\research\research-workspace\interactive-auto-mapping-tool\test-systems\ant\src\main\org\apache\tools\ant\util\XMLFragment.java", "Java", 67, 0, 0, 0, 73, 17, 157
"c:\Users\zipasink\OneDrive\PhD\research\research-workspace\interactive-auto-mapping-tool\test-systems\ant\src\main\org\apache\tools\ant\util\XmlConstants.java", "Java", 22, 0, 0, 0, 36, 4, 62
"c:\Users\zipasink\OneDrive\PhD\research\research-workspace\interactive-auto-mapping-tool\test-systems\ant\src\main\org\apache\tools\ant\util\depend\AbstractAnalyzer.java", "Java", 113, 0, 0, 0, 145, 27, 285
"c:\Users\zipasink\OneDrive\PhD\research\research-workspace\interactive-auto-mapping-tool\test-systems\ant\src\main\org\apache\tools\ant\util\depend\DependencyAnalyzer.java", "Java", 17, 0, 0, 0, 99, 14, 130
"c:\Users\zipasink\OneDrive\PhD\research\research-workspace\interactive-auto-mapping-tool\test-systems\ant\src\main\org\apache\tools\ant\util\depend\bcel\AncestorAnalyzer.java", "Java", 79, 0, 0, 0, 46, 14, 139
"c:\Users\zipasink\OneDrive\PhD\research\research-workspace\interactive-auto-mapping-tool\test-systems\ant\src\main\org\apache\tools\ant\util\depend\bcel\DependencyVisitor.java", "Java", 83, 0, 0, 0, 91, 15, 189
"c:\Users\zipasink\OneDrive\PhD\research\research-workspace\interactive-auto-mapping-tool\test-systems\ant\src\main\org\apache\tools\ant\util\depend\bcel\FullAnalyzer.java", "Java", 74, 0, 0, 0, 46, 12, 132
"c:\Users\zipasink\OneDrive\PhD\research\research-workspace\interactive-auto-mapping-tool\test-systems\ant\src\main\org\apache\tools\ant\util\facade\FacadeTaskHelper.java", "Java", 50, 0, 0, 0, 78, 17, 145
"c:\Users\zipasink\OneDrive\PhD\research\research-workspace\interactive-auto-mapping-tool\test-systems\ant\src\main\org\apache\tools\ant\util\facade\ImplementationSpecificArgument.java", "Java", 18, 0, 0, 0, 37, 7, 62
"c:\Users\zipasink\OneDrive\PhD\research\research-workspace\interactive-auto-mapping-tool\test-systems\ant\src\main\org\apache\tools\ant\util\java15\ProxyDiagnostics.java", "Java", 59, 0, 0, 0, 39, 14, 112
"c:\Users\zipasink\OneDrive\PhD\research\research-workspace\interactive-auto-mapping-tool\test-systems\ant\src\main\org\apache\tools\ant\util\optional\JavaxScriptRunner.java", "Java", 78, 0, 0, 0, 43, 11, 132
"c:\Users\zipasink\OneDrive\PhD\research\research-workspace\interactive-auto-mapping-tool\test-systems\ant\src\main\org\apache\tools\ant\util\optional\NoExitSecurityManager.java", "Java", 10, 0, 0, 0, 36, 5, 51
"c:\Users\zipasink\OneDrive\PhD\research\research-workspace\interactive-auto-mapping-tool\test-systems\ant\src\main\org\apache\tools\ant\util\optional\ScriptRunner.java", "Java", 118, 0, 0, 0, 59, 15, 192
"c:\Users\zipasink\OneDrive\PhD\research\research-workspace\interactive-auto-mapping-tool\test-systems\ant\src\main\org\apache\tools\ant\util\optional\WeakishReference12.java", "Java", 7, 0, 0, 0, 33, 6, 46
"c:\Users\zipasink\OneDrive\PhD\research\research-workspace\interactive-auto-mapping-tool\test-systems\ant\src\main\org\apache\tools\ant\util\regexp\JakartaOroMatcher.java", "Java", 70, 0, 0, 0, 82, 17, 169
"c:\Users\zipasink\OneDrive\PhD\research\research-workspace\interactive-auto-mapping-tool\test-systems\ant\src\main\org\apache\tools\ant\util\regexp\JakartaOroRegexp.java", "Java", 51, 0, 0, 0, 38, 11, 100
"c:\Users\zipasink\OneDrive\PhD\research\research-workspace\interactive-auto-mapping-tool\test-systems\ant\src\main\org\apache\tools\ant\util\regexp\JakartaRegexpMatcher.java", "Java", 68, 0, 0, 0, 77, 17, 162
"c:\Users\zipasink\OneDrive\PhD\research\research-workspace\interactive-auto-mapping-tool\test-systems\ant\src\main\org\apache\tools\ant\util\regexp\JakartaRegexpRegexp.java", "Java", 44, 0, 0, 0, 37, 9, 90
"c:\Users\zipasink\OneDrive\PhD\research\research-workspace\interactive-auto-mapping-tool\test-systems\ant\src\main\org\apache\tools\ant\util\regexp\Jdk14RegexpMatcher.java", "Java", 73, 0, 0, 0, 80, 17, 170
"c:\Users\zipasink\OneDrive\PhD\research\research-workspace\interactive-auto-mapping-tool\test-systems\ant\src\main\org\apache\tools\ant\util\regexp\Jdk14RegexpRegexp.java", "Java", 58, 0, 0, 0, 37, 11, 106
"c:\Users\zipasink\OneDrive\PhD\research\research-workspace\interactive-auto-mapping-tool\test-systems\ant\src\main\org\apache\tools\ant\util\regexp\Regexp.java", "Java", 8, 0, 0, 0, 37, 6, 51
"c:\Users\zipasink\OneDrive\PhD\research\research-workspace\interactive-auto-mapping-tool\test-systems\ant\src\main\org\apache\tools\ant\util\regexp\RegexpFactory.java", "Java", 53, 0, 0, 0, 48, 15, 116
"c:\Users\zipasink\OneDrive\PhD\research\research-workspace\interactive-auto-mapping-tool\test-systems\ant\src\main\org\apache\tools\ant\util\regexp\RegexpMatcher.java", "Java", 15, 0, 0, 0, 79, 16, 110
"c:\Users\zipasink\OneDrive\PhD\research\research-workspace\interactive-auto-mapping-tool\test-systems\ant\src\main\org\apache\tools\ant\util\regexp\RegexpMatcherFactory.java", "Java", 66, 0, 0, 0, 55, 16, 137
"c:\Users\zipasink\OneDrive\PhD\research\research-workspace\interactive-auto-mapping-tool\test-systems\ant\src\main\org\apache\tools\ant\util\regexp\RegexpUtil.java", "Java", 9, 0, 0, 0, 36, 5, 50
"c:\Users\zipasink\OneDrive\PhD\research\research-workspace\interactive-auto-mapping-tool\test-systems\ant\src\main\org\apache\tools\bzip2\BZip2Constants.java", "Java", 67, 0, 0, 0, 37, 6, 110
"c:\Users\zipasink\OneDrive\PhD\research\research-workspace\interactive-auto-mapping-tool\test-systems\ant\src\main\org\apache\tools\bzip2\CBZip2InputStream.java", "Java", 704, 0, 0, 0, 129, 144, 977
"c:\Users\zipasink\OneDrive\PhD\research\research-workspace\interactive-auto-mapping-tool\test-systems\ant\src\main\org\apache\tools\bzip2\CBZip2OutputStream.java", "Java", 1399, 0, 0, 0, 406, 302, 2107
"c:\Users\zipasink\OneDrive\PhD\research\research-workspace\interactive-auto-mapping-tool\test-systems\ant\src\main\org\apache\tools\bzip2\CRC.java", "Java", 102, 0, 0, 0, 27, 13, 142
"c:\Users\zipasink\OneDrive\PhD\research\research-workspace\interactive-auto-mapping-tool\test-systems\ant\src\main\org\apache\tools\mail\ErrorInQuitException.java", "Java", 7, 0, 0, 0, 31, 6, 44
"c:\Users\zipasink\OneDrive\PhD\research\research-workspace\interactive-auto-mapping-tool\test-systems\ant\src\main\org\apache\tools\mail\MailMessage.java", "Java", 271, 0, 0, 0, 197, 58, 526
"c:\Users\zipasink\OneDrive\PhD\research\research-workspace\interactive-auto-mapping-tool\test-systems\ant\src\main\org\apache\tools\mail\SmtpResponseReader.java", "Java", 40, 0, 0, 0, 51, 10, 101
"c:\Users\zipasink\OneDrive\PhD\research\research-workspace\interactive-auto-mapping-tool\test-systems\ant\src\main\org\apache\tools\tar\TarBuffer.java", "Java", 230, 0, 0, 0, 159, 73, 462
"c:\Users\zipasink\OneDrive\PhD\research\research-workspace\interactive-auto-mapping-tool\test-systems\ant\src\main\org\apache\tools\tar\TarConstants.java", "Java", 28, 0, 0, 0, 101, 30, 159
"c:\Users\zipasink\OneDrive\PhD\research\research-workspace\interactive-auto-mapping-tool\test-systems\ant\src\main\org\apache\tools\tar\TarEntry.java", "Java", 268, 0, 0, 0, 280, 91, 639
"c:\Users\zipasink\OneDrive\PhD\research\research-workspace\interactive-auto-mapping-tool\test-systems\ant\src\main\org\apache\tools\tar\TarInputStream.java", "Java", 188, 0, 0, 0, 149, 57, 394
"c:\Users\zipasink\OneDrive\PhD\research\research-workspace\interactive-auto-mapping-tool\test-systems\ant\src\main\org\apache\tools\tar\TarOutputStream.java", "Java", 155, 0, 0, 0, 152, 49, 356
"c:\Users\zipasink\OneDrive\PhD\research\research-workspace\interactive-auto-mapping-tool\test-systems\ant\src\main\org\apache\tools\tar\TarUtils.java", "Java", 84, 0, 0, 0, 84, 32, 200
"c:\Users\zipasink\OneDrive\PhD\research\research-workspace\interactive-auto-mapping-tool\test-systems\ant\src\main\org\apache\tools\zip\AsiExtraField.java", "Java", 121, 0, 0, 0, 178, 35, 334
"c:\Users\zipasink\OneDrive\PhD\research\research-workspace\interactive-auto-mapping-tool\test-systems\ant\src\main\org\apache\tools\zip\ExtraFieldUtils.java", "Java", 99, 0, 0, 0, 64, 12, 175
"c:\Users\zipasink\OneDrive\PhD\research\research-workspace\interactive-auto-mapping-tool\test-systems\ant\src\main\org\apache\tools\zip\JarMarker.java", "Java", 34, 0, 0, 0, 62, 13, 109
"c:\Users\zipasink\OneDrive\PhD\research\research-workspace\interactive-auto-mapping-tool\test-systems\ant\src\main\org\apache\tools\zip\UnixStat.java", "Java", 10, 0, 0, 0, 60, 6, 76
"c:\Users\zipasink\OneDrive\PhD\research\research-workspace\interactive-auto-mapping-tool\test-systems\ant\src\main\org\apache\tools\zip\UnrecognizedExtraField.java", "Java", 41, 0, 0, 0, 82, 15, 138
"c:\Users\zipasink\OneDrive\PhD\research\research-workspace\interactive-auto-mapping-tool\test-systems\ant\src\main\org\apache\tools\zip\ZipEntry.java", "Java", 151, 0, 0, 0, 183, 35, 369
"c:\Users\zipasink\OneDrive\PhD\research\research-workspace\interactive-auto-mapping-tool\test-systems\ant\src\main\org\apache\tools\zip\ZipExtraField.java", "Java", 11, 0, 0, 0, 65, 10, 86
"c:\Users\zipasink\OneDrive\PhD\research\research-workspace\interactive-auto-mapping-tool\test-systems\ant\src\main\org\apache\tools\zip\ZipFile.java", "Java", 313, 0, 0, 0, 196, 60, 569
"c:\Users\zipasink\OneDrive\PhD\research\research-workspace\interactive-auto-mapping-tool\test-systems\ant\src\main\org\apache\tools\zip\ZipLong.java", "Java", 46, 0, 0, 0, 75, 14, 135
"c:\Users\zipasink\OneDrive\PhD\research\research-workspace\interactive-auto-mapping-tool\test-systems\ant\src\main\org\apache\tools\zip\ZipOutputStream.java", "Java", 373, 0, 0, 0, 422, 106, 901
"c:\Users\zipasink\OneDrive\PhD\research\research-workspace\interactive-auto-mapping-tool\test-systems\ant\src\main\org\apache\tools\zip\ZipShort.java", "Java", 45, 0, 0, 0, 75, 14, 134
"Total", "-", 93511, 275, 44, 53, 84174, 21151, 199208